repository,pr_number,pr_outcome,weighted_negativity_ratio,total_feedback,has_any_negative_feedback,num_positive_comments,num_neutral_comments,num_negative_comments,total_comments,num_positive_reviews,num_neutral_reviews,num_negative_reviews,total_reviews,num_positive_review_comments,num_neutral_review_comments,num_negative_review_comments,total_review_comments
redis,11695,merged,0.0440402106270943,1044.5,1,9,51,2,62,7,6,1,14,17,287,14,318
redis,9788,merged,0.03502129673450071,1056.5,1,10,36,4,50,2,9,0,11,13,304,11,328
redis,11012,merged,0.07247298156389065,786.5,1,7,40,3,50,2,3,0,5,12,212,18,242
redis,9357,merged,0.06397562833206398,656.5,1,1,19,0,20,0,6,0,6,5,189,14,208
redis,10285,merged,0.09254901960784313,637.5,1,2,16,0,18,6,4,1,11,5,175,19,199
redis,12109,rejected,0.08215085884988797,669.5,1,2,5,1,8,2,3,0,5,10,189,18,217
redis,9323,merged,0.0684811237928007,569.5,1,8,20,1,29,4,7,1,12,18,142,12,172
redis,9166,merged,0.062088428974600186,531.5,1,4,12,0,16,1,3,0,4,3,155,11,169
redis,10517,rejected,0.059009483667017915,474.5,1,12,42,7,61,2,8,0,10,9,115,7,131
redis,13157,merged,0.24438902743142144,200.5,1,30,116,49,195,0,1,0,1,0,1,0,1
redis,9320,merged,0.06444188722669736,434.5,1,18,42,4,64,3,2,3,8,3,109,6,118
redis,9934,merged,0.09467455621301775,422.5,1,9,52,8,69,2,1,1,4,5,100,10,115
redis,9202,merged,0.05194805194805195,346.5,1,1,9,0,10,4,2,0,6,5,97,6,108
redis,9974,merged,0.08150470219435736,478.5,1,2,15,3,20,2,2,0,4,7,131,12,150
redis,10273,merged,0.0499457111834962,460.5,1,2,16,3,21,0,1,1,2,1,138,6,145
redis,9406,merged,0.07115628970775095,393.5,1,2,54,7,63,1,2,0,3,0,101,7,108
redis,9462,merged,0.07150595882990249,461.5,1,5,12,0,17,1,2,0,3,9,126,11,146
redis,9504,merged,0.09805924412665985,489.5,1,0,6,0,6,1,5,0,6,4,137,16,157
redis,8887,merged,0.09100998890122086,450.5,1,6,26,2,34,1,3,0,4,5,118,13,136
redis,11303,merged,0.0867630700778643,449.5,1,2,23,0,25,1,4,0,5,7,118,13,138
redis,8621,merged,0.11630558722919042,438.5,1,4,16,3,23,1,10,0,11,4,111,16,131
redis,9656,merged,0.03785488958990536,475.5,1,1,9,0,10,0,3,0,3,3,144,6,153
redis,11659,merged,0.02944507361268403,441.5,1,1,6,1,8,0,8,0,8,6,129,4,139
redis,9572,merged,0.08888888888888889,382.5,1,2,32,7,41,1,3,0,4,12,90,9,111
redis,13740,merged,0.009962640099626401,401.5,1,0,11,1,12,1,6,0,7,9,115,1,125
redis,9872,merged,0.06420927467300833,420.5,1,2,5,0,7,1,3,0,4,8,118,9,135
redis,10536,merged,0.06279434850863422,318.5,1,12,35,3,50,2,5,1,8,8,71,5,84
redis,9127,merged,0.03495630461922597,400.5,1,3,7,2,12,0,5,0,5,10,112,4,126
redis,10108,merged,0.04449938195302843,404.5,1,1,9,0,10,1,1,0,2,7,117,6,130
redis,11568,merged,0.04878048780487805,348.5,1,1,19,2,22,2,2,0,4,6,95,5,106
redis,11963,merged,0.1480484522207268,371.5,1,3,19,2,24,0,3,1,4,3,93,17,113
redis,9822,merged,0.05324459234608985,300.5,1,11,24,4,39,0,3,0,3,7,74,4,85
redis,12822,merged,0.05519053876478318,380.5,1,1,10,0,11,2,1,0,3,5,109,7,121
redis,9564,merged,0.047217537942664416,296.5,1,8,15,2,25,2,6,0,8,9,72,4,85
redis,10515,merged,0.09954751131221719,331.5,1,9,20,6,35,1,3,0,4,8,79,9,96
redis,10966,merged,0.09379727685325265,330.5,1,0,10,4,14,0,2,0,2,1,94,9,104
redis,6929,merged,0.037267080745341616,241.5,1,19,35,3,57,4,1,0,5,1,55,2,58
redis,8687,merged,0.046176046176046176,346.5,1,0,8,1,9,0,5,0,5,11,93,5,109
redis,6891,merged,0.06846846846846846,277.5,1,7,7,0,14,2,6,2,10,3,73,5,81
redis,8242,merged,0.06349206349206349,220.5,1,8,56,8,72,2,0,0,2,0,46,2,48
redis,9601,merged,0.09295352323838081,333.5,1,1,10,4,15,3,0,0,3,5,90,9,104
redis,13209,merged,0.10419681620839363,345.5,1,0,3,1,4,0,0,1,1,4,98,11,113
redis,12209,merged,0.09108159392789374,263.5,1,8,17,3,28,1,1,0,2,11,59,7,77
redis,9890,merged,0.08517887563884156,293.5,1,5,12,5,22,0,1,1,2,1,82,6,89
redis,10293,merged,0.05148514851485148,252.5,1,5,32,1,38,1,4,0,5,5,59,4,68
redis,13243,merged,0.06153846153846154,292.5,1,3,8,0,11,0,1,0,1,4,83,6,93
redis,9530,merged,0.07127882599580712,238.5,1,10,36,2,48,0,2,0,2,5,52,5,62
redis,12453,merged,0.058287795992714025,274.5,1,3,8,1,12,1,4,0,5,3,76,5,84
redis,11290,merged,0.02578268876611418,271.5,1,4,15,1,20,1,3,0,4,8,71,2,81
redis,9938,merged,0.06349206349206349,283.5,1,0,2,0,2,1,3,0,4,7,78,6,91
redis,8288,merged,0.0784313725490196,280.5,1,5,7,2,14,1,2,1,4,12,68,6,86
redis,12658,merged,0.032667876588021776,275.5,1,2,8,0,10,1,1,0,2,3,81,3,87
redis,9812,merged,0.03956043956043956,227.5,1,2,28,0,30,0,7,0,7,0,58,3,61
redis,12826,merged,0.016713091922005572,179.5,1,7,9,0,16,2,3,0,5,8,42,1,51
redis,8974,merged,0.08899297423887588,213.5,1,5,21,1,27,0,3,0,3,4,50,6,60
redis,9780,merged,0.10855949895615867,239.5,1,1,12,0,13,0,4,1,5,6,58,8,72
redis,9309,merged,0.07529411764705882,212.5,1,1,13,1,15,0,4,0,4,2,56,5,63
redis,9940,merged,0.05894736842105263,237.5,1,1,11,2,14,1,4,0,5,1,66,4,71
redis,11248,merged,0.11764705882352941,229.5,1,5,16,1,22,0,2,1,3,1,58,8,67
redis,8474,merged,0.07127882599580712,238.5,1,4,8,2,14,1,3,0,4,7,60,5,72
redis,8217,merged,0.05393258426966292,222.5,1,1,17,0,18,2,1,0,3,6,56,4,66
redis,10061,merged,0.06266318537859007,191.5,1,1,18,0,19,0,2,0,2,1,51,4,56
redis,10127,merged,0.052104208416833664,249.5,1,1,5,1,7,0,1,0,1,6,70,4,80
redis,9356,merged,0.033444816053511704,149.5,1,14,38,2,54,1,3,0,4,4,24,1,29
redis,11193,rejected,0.09324009324009325,214.5,1,2,14,3,19,0,2,1,3,4,54,5,63
redis,9963,merged,0.15424164524421594,194.5,1,2,12,0,14,2,1,0,3,1,47,10,58
redis,12817,merged,0.013729977116704805,218.5,1,1,17,0,18,0,1,0,1,0,65,1,66
redis,9748,merged,0.050955414012738856,235.5,1,1,4,0,5,0,1,0,1,3,69,4,76
redis,10004,merged,0.0316622691292876,189.5,1,1,15,0,16,0,4,0,4,0,53,2,55
redis,11199,merged,0.05321507760532151,225.5,1,1,4,0,5,1,1,0,2,2,66,4,72
redis,8315,merged,0.05517241379310345,217.5,1,1,7,0,8,0,4,0,4,2,61,4,67
redis,8170,merged,0.13870246085011187,223.5,1,0,6,1,7,2,4,0,6,5,53,10,68
redis,10043,merged,0.09014084507042254,177.5,1,2,23,5,30,0,2,1,3,0,44,3,47
redis,8324,merged,0.06233766233766234,192.5,1,1,16,0,17,0,5,0,5,0,51,4,55
redis,12913,merged,0.14797136038186157,209.5,1,0,10,1,11,1,5,0,6,1,51,10,62
redis,11708,merged,0.09187279151943463,141.5,1,3,9,1,13,0,4,0,4,2,34,4,40
redis,12192,rejected,0.1976284584980237,126.5,1,5,37,10,52,1,0,0,1,2,17,5,24
redis,8327,merged,0.0694006309148265,158.5,1,4,18,2,24,1,3,0,4,7,32,3,42
redis,11595,merged,0.14007782101167315,128.5,1,8,34,6,48,0,1,0,1,1,21,4,26
redis,2143,merged,0.0781758957654723,153.5,1,22,11,3,36,0,0,0,0,14,22,3,39
redis,12416,rejected,0.06303724928366762,174.5,1,0,3,2,5,2,0,0,2,6,46,3,55
redis,9511,merged,0.021333333333333333,187.5,1,1,3,1,5,3,1,0,4,2,55,1,58
redis,12611,merged,0.06472491909385113,154.5,1,2,24,4,30,2,3,0,5,4,32,2,38
redis,9774,merged,0.08996539792387544,144.5,1,4,24,7,35,0,8,0,8,2,27,2,31
redis,13592,merged,0.059800664451827246,150.5,1,1,3,0,4,1,0,0,1,4,41,3,48
redis,9003,merged,0.08086253369272237,185.5,1,0,9,1,10,0,4,1,5,3,48,4,55
redis,11907,rejected,0.05054151624548736,138.5,1,2,17,1,20,4,1,0,5,1,33,2,36
redis,12742,merged,0.096,187.5,1,1,5,0,6,0,5,0,5,3,48,6,57
redis,10636,merged,0.07228915662650602,207.5,1,0,2,0,2,0,2,0,2,1,61,5,67
redis,10969,merged,0.02881844380403458,173.5,1,0,7,0,7,0,1,1,2,1,52,1,54
redis,10747,rejected,0.1253731343283582,167.5,1,11,9,2,22,0,0,2,2,4,38,5,47
redis,8999,merged,0.050761421319796954,98.5,1,2,24,5,31,2,0,0,2,1,20,0,21
redis,13285,merged,0.0364741641337386,164.5,1,0,2,0,2,0,0,0,0,6,46,2,54
redis,11982,merged,0.041811846689895474,143.5,1,0,29,0,29,0,0,0,0,1,35,2,38
redis,13359,merged,0.03524229074889868,113.5,1,6,27,4,37,0,2,0,2,1,23,0,24
redis,8094,merged,0.0633245382585752,189.5,1,1,5,0,6,2,1,0,3,10,45,4,59
redis,13169,rejected,0.019138755980861243,104.5,1,8,20,2,30,11,26,0,37,0,0,0,0
redis,2795,merged,0.07468879668049792,120.5,1,7,9,0,16,1,3,0,4,2,27,3,32
redis,7953,merged,0.10746268656716418,167.5,1,5,8,1,14,1,4,1,6,3,39,5,47
redis,7912,merged,0.008733624454148471,114.5,1,10,28,1,39,3,3,0,6,1,20,0,21
kafka,2929,rejected,0.040695523492415835,1351.5,1,22,12,1,35,10,3,0,13,59,353,18,430
kafka,9001,merged,0.02657091561938959,1392.5,1,10,7,1,18,11,4,0,15,18,418,12,448
kafka,2476,rejected,0.064797507788162,802.5,1,20,13,2,35,9,0,1,10,36,197,16,249
kafka,2614,rejected,0.0381807973048849,890.5,1,4,8,1,13,8,6,0,14,17,255,11,283
kafka,3131,rejected,0.0,1.5,0,0,1,0,1,0,0,0,0,0,0,0,0
kafka,3874,rejected,0.03653395784543326,1067.5,1,13,22,0,35,8,1,0,9,54,271,13,338
kafka,1215,rejected,0.0483955812730142,950.5,1,26,32,4,62,0,0,0,0,10,272,14,296
kafka,5527,merged,0.08768768768768768,832.5,1,44,63,11,118,5,3,1,9,26,186,20,232
kafka,8680,merged,0.014771048744460856,1015.5,1,2,7,0,9,16,1,0,17,33,286,5,324
kafka,14406,merged,0.05281173594132029,1022.5,1,0,6,3,9,10,0,0,10,31,283,17,331
kafka,11390,merged,0.0187012987012987,962.5,1,11,5,0,16,14,0,0,14,15,285,6,306
kafka,6363,merged,0.03759791122715405,957.5,1,3,2,0,5,8,3,0,11,38,260,12,310
kafka,5582,merged,0.03282674772036474,822.5,1,9,42,4,55,6,0,1,7,5,239,7,251
kafka,8657,merged,0.05114029025570145,723.5,1,22,53,9,84,22,0,2,24,15,174,8,197
kafka,2264,rejected,0.051584377302873984,678.5,1,3,10,2,15,3,6,0,9,11,193,11,215
kafka,14182,rejected,0.04743083003952569,885.5,1,0,1,0,1,4,3,0,7,6,270,14,290
kafka,764,rejected,0.021778584392014518,826.5,1,22,15,0,37,0,0,0,0,12,245,6,263
kafka,13870,merged,0.0548258138206739,875.5,1,2,4,0,6,5,5,0,10,7,260,16,283
kafka,9944,merged,0.06275902901124926,844.5,1,2,14,0,16,12,2,1,15,11,238,17,266
kafka,13443,merged,0.08072768618533258,879.5,1,0,1,0,1,6,0,1,7,16,249,23,288
kafka,6592,merged,0.043507817811012914,735.5,1,27,30,7,64,4,7,5,16,13,195,5,213
kafka,5567,merged,0.0514752040175769,796.5,1,7,14,0,21,5,8,1,14,28,208,13,249
kafka,11331,merged,0.0620815581253804,821.5,1,1,7,0,8,4,2,0,6,9,241,17,267
kafka,4756,rejected,0.05324232081911263,732.5,1,7,30,1,38,4,6,1,11,14,198,12,224
kafka,1446,rejected,0.028402366863905324,422.5,1,19,25,1,45,1,5,1,7,15,103,3,121
kafka,5101,rejected,0.0121049092131809,743.5,1,16,12,0,28,14,0,0,14,19,207,3,229
kafka,6295,rejected,0.01583873290136789,694.5,1,13,26,2,41,5,8,0,13,26,180,3,209
kafka,9485,merged,0.023952095808383235,751.5,1,7,10,0,17,6,1,0,7,9,225,6,240
kafka,1776,rejected,0.015276893698281349,785.5,1,1,1,0,2,0,0,0,0,65,192,4,261
kafka,14690,merged,0.03289924605894448,729.5,1,4,4,1,9,5,0,1,6,18,211,7,236
kafka,2466,rejected,0.04935370152761457,425.5,1,4,24,6,34,9,5,0,14,7,109,5,121
kafka,6694,merged,0.02629416598192276,608.5,1,9,48,3,60,7,1,2,10,12,161,3,176
kafka,4931,rejected,0.028551034975017844,700.5,1,3,5,0,8,7,5,1,13,6,210,6,222
kafka,6177,merged,0.03137902559867878,605.5,1,20,22,1,43,4,4,0,8,27,149,6,182
kafka,2772,rejected,0.024778761061946902,282.5,1,9,7,1,17,3,2,0,5,8,75,2,85
kafka,2330,rejected,0.016824395373291272,475.5,1,4,16,0,20,7,2,1,10,3,140,2,145
kafka,7170,merged,0.025202520252025202,555.5,1,25,21,4,50,5,1,2,8,21,140,2,163
kafka,7884,rejected,0.048604860486048604,555.5,1,14,42,1,57,11,0,1,12,5,145,8,158
kafka,2735,rejected,0.023084994753410283,476.5,1,2,8,2,12,3,4,0,7,6,141,3,150
kafka,130,rejected,0.027695351137487636,505.5,1,5,9,2,16,0,0,0,0,9,150,4,163
kafka,3621,rejected,0.07992733878292461,550.5,1,11,5,2,18,8,0,0,8,27,131,14,172
kafka,7898,rejected,0.05448354143019296,440.5,1,31,73,15,119,5,1,0,6,12,88,3,103
kafka,9039,merged,0.03747072599531616,640.5,1,0,4,0,4,4,2,0,6,24,176,8,208
kafka,16456,merged,0.009167303284950344,654.5,1,3,1,0,4,11,2,0,13,35,171,2,208
kafka,14364,merged,0.03330689928628073,630.5,1,9,5,0,14,7,1,0,8,10,183,7,200
kafka,17373,merged,0.0384967919340055,545.5,1,20,32,3,55,12,2,0,14,13,135,6,154
kafka,13561,merged,0.04329725228975854,600.5,1,7,15,0,22,17,1,1,19,22,150,8,180
kafka,5201,merged,0.031799163179916316,597.5,1,1,24,1,26,1,4,0,5,7,174,6,187
kafka,13639,merged,0.041315990818668706,653.5,1,2,0,0,2,4,2,0,6,8,196,9,213
kafka,4812,rejected,0.0374468085106383,587.5,1,3,22,1,26,4,11,0,15,22,148,7,177
kafka,7378,merged,0.004758128469468675,630.5,1,1,12,0,13,4,0,0,4,4,198,1,203
kafka,5709,merged,0.0380650277557494,630.5,1,0,12,0,12,2,1,0,3,11,185,8,204
kafka,812,rejected,0.014646053702196907,614.5,1,13,7,0,20,0,0,0,0,11,184,3,198
kafka,165,rejected,0.057190916736753576,594.5,1,3,20,1,24,0,0,0,0,10,169,11,190
kafka,17539,merged,0.030571198712791632,621.5,1,5,0,1,6,13,2,0,15,2,187,6,195
kafka,2849,rejected,0.043513295729250605,620.5,1,2,4,0,6,3,1,0,4,8,185,9,202
kafka,2964,rejected,0.020924149956408022,573.5,1,2,6,0,8,3,2,0,5,11,170,4,185
kafka,1884,rejected,0.02459791863765374,528.5,1,1,15,1,17,2,3,0,5,10,153,4,167
kafka,5379,merged,0.0567139282735613,599.5,1,2,5,1,8,7,2,0,9,8,172,11,191
kafka,191,rejected,0.03234501347708895,556.5,1,10,21,0,31,0,0,0,0,3,166,6,175
kafka,10070,merged,0.029387755102040815,612.5,1,1,1,0,2,7,4,0,11,14,176,6,196
kafka,3765,rejected,0.00529567519858782,566.5,1,3,17,0,20,8,1,0,9,10,165,1,176
kafka,13240,rejected,0.06142728093947606,553.5,1,17,12,1,30,2,3,0,5,12,148,11,171
kafka,2140,rejected,0.05703048180924287,508.5,1,9,11,2,22,5,1,0,6,9,140,9,158
kafka,4830,rejected,0.0,567.5,0,9,6,0,15,6,3,0,9,5,173,0,178
kafka,9103,merged,0.04741000877963126,569.5,1,1,5,0,6,5,2,0,7,3,171,9,183
kafka,132,rejected,0.03773584905660377,503.5,1,11,29,4,44,0,0,0,0,11,137,5,153
kafka,5693,merged,0.05258545135845749,570.5,1,2,10,0,12,5,4,0,9,15,155,10,180
kafka,5821,merged,0.022628372497824196,574.5,1,6,4,1,11,7,0,0,7,23,156,4,183
kafka,5428,merged,0.033426183844011144,538.5,1,3,15,0,18,3,5,0,8,27,135,6,168
kafka,2743,rejected,0.03065134099616858,391.5,1,1,4,0,5,3,1,0,4,1,121,4,126
kafka,18240,merged,0.021447721179624665,559.5,1,0,1,0,1,5,4,0,9,7,169,4,180
kafka,2244,rejected,0.1090458488228005,403.5,1,1,10,0,11,0,3,1,4,6,108,14,128
kafka,2074,rejected,0.04397905759162304,477.5,1,7,3,0,10,2,2,0,4,27,119,7,153
kafka,3849,rejected,0.0282021151586369,425.5,1,3,44,3,50,7,2,0,9,3,113,3,119
kafka,1336,rejected,0.0658513640639699,531.5,1,15,6,0,21,1,1,1,3,23,134,11,168
kafka,2744,rejected,0.04195804195804196,357.5,1,7,3,0,10,7,0,0,7,7,99,5,111
kafka,9487,merged,0.07203791469194312,527.5,1,0,4,0,4,5,2,1,8,11,146,12,169
kafka,10851,merged,0.0594059405940594,454.5,1,19,10,8,37,16,0,2,18,29,93,5,127
kafka,195,rejected,0.030211480362537766,496.5,1,3,7,0,10,0,0,0,0,6,151,5,162
kafka,2910,rejected,0.02771362586605081,216.5,1,2,6,0,8,4,1,0,5,2,62,2,66
kafka,10579,merged,0.03367633302151544,534.5,1,7,1,0,8,8,0,0,8,9,155,6,170
kafka,3325,rejected,0.0070838252656434475,423.5,1,4,17,0,21,3,3,0,6,3,126,1,130
kafka,10218,merged,0.03471552555448409,518.5,1,6,4,0,10,14,0,0,14,10,144,6,160
kafka,14432,merged,0.03758654797230465,505.5,1,11,3,1,15,8,0,0,8,7,145,6,158
kafka,14408,merged,0.022535211267605635,532.5,1,0,0,0,0,7,1,0,8,3,165,4,172
kafka,9100,merged,0.07536231884057971,517.5,1,3,4,0,7,1,2,0,3,8,147,13,168
kafka,2472,rejected,0.08,337.5,1,3,2,0,5,2,2,0,4,6,93,9,108
kafka,8218,merged,0.050156739811912224,478.5,1,4,17,0,21,2,6,0,8,9,130,8,147
kafka,1095,rejected,0.062062062062062065,499.5,1,5,7,1,13,0,0,0,0,18,134,10,162
kafka,7629,merged,0.033946251768033946,353.5,1,0,7,0,7,2,3,0,5,3,105,4,112
kafka,8589,merged,0.05029940119760479,417.5,1,20,17,3,40,5,2,0,7,10,105,6,121
kafka,5322,rejected,0.009864364981504316,405.5,1,6,40,1,47,1,4,0,5,4,111,1,116
kafka,13391,merged,0.05708460754332314,490.5,1,0,6,1,7,6,0,0,6,6,142,9,157
kafka,1251,rejected,0.06153846153846154,357.5,1,9,29,2,40,3,0,1,4,8,89,6,103
kafka,151,rejected,0.028004667444574097,428.5,1,6,17,0,23,0,0,0,0,12,119,4,135
kafka,2967,rejected,0.02557544757033248,195.5,1,0,8,0,8,3,1,1,5,5,53,1,59
kafka,2719,rejected,0.08617594254937164,278.5,1,6,8,0,14,2,1,0,3,4,74,8,86
kafka,10822,merged,0.01251303441084463,479.5,1,1,6,0,7,8,0,0,8,21,129,2,152
kafka,15640,merged,0.03925845147219193,458.5,1,7,13,0,20,8,1,0,9,11,123,6,140
terminal,737,rejected,0.05863192182410423,153.5,1,0,12,3,15,0,0,0,0,0,44,2,46
terminal,330,rejected,0.1459227467811159,116.5,1,3,15,2,20,1,2,0,3,1,24,5,30
terminal,584,merged,0.03755868544600939,106.5,1,3,13,1,17,1,0,0,1,1,27,1,29
terminal,386,rejected,0.014598540145985401,68.5,1,5,21,1,27,0,1,0,1,0,13,0,13
terminal,505,merged,0.061855670103092786,48.5,1,2,8,3,13,1,3,0,4,1,8,0,9
terminal,742,merged,0.1322314049586777,60.5,1,1,9,0,10,2,1,1,4,0,12,2,14
terminal,542,rejected,0.013605442176870748,73.5,1,2,5,1,8,1,0,0,1,3,18,0,21
terminal,160,merged,0.020618556701030927,48.5,1,0,9,1,10,3,1,0,4,0,10,0,10
terminal,125,merged,0.09876543209876543,40.5,1,2,6,1,9,3,2,0,5,0,6,1,7
terminal,760,merged,0.3389830508474576,29.5,1,5,7,2,14,0,2,1,3,0,1,2,3
terminal,687,rejected,0.08888888888888889,22.5,1,0,7,2,9,0,2,0,2,0,3,0,3
terminal,265,merged,0.08955223880597014,33.5,1,3,5,0,8,1,4,0,5,0,4,1,5
terminal,662,merged,0.0,33.5,0,1,8,0,9,2,1,0,3,0,6,0,6
terminal,486,rejected,0.23880597014925373,33.5,1,1,7,2,10,1,0,0,1,0,5,2,7
terminal,87,merged,0.12345679012345678,40.5,1,0,4,0,4,1,1,1,3,0,9,1,10
terminal,798,merged,0.2318840579710145,34.5,1,2,4,2,8,1,0,0,1,2,4,2,8
terminal,743,merged,0.0,41.5,0,1,2,0,3,0,1,0,1,0,12,0,12
terminal,595,merged,0.0,43.5,0,0,0,0,0,2,0,0,2,3,10,0,13
terminal,397,merged,0.0,26.5,0,2,0,0,2,1,2,0,3,4,2,0,6
terminal,602,merged,0.03773584905660377,26.5,1,0,6,1,7,1,1,0,2,0,5,0,5
terminal,504,merged,0.2222222222222222,22.5,1,1,5,2,8,1,0,0,1,0,3,1,4
terminal,556,rejected,0.0392156862745098,25.5,1,1,4,1,6,1,1,0,2,0,5,0,5
terminal,753,merged,0.08955223880597014,33.5,1,1,1,0,2,1,1,0,2,1,7,1,9
terminal,266,rejected,0.08,12.5,1,0,11,1,12,0,0,0,0,0,0,0,0
terminal,590,merged,0.0,22.5,0,1,5,0,6,1,1,0,2,0,4,0,4
terminal,794,merged,0.0,23.5,0,1,4,0,5,2,1,0,3,0,4,0,4
terminal,390,merged,0.16326530612244897,24.5,1,1,1,1,3,0,3,0,3,1,3,1,5
terminal,349,merged,0.0,23.5,0,3,1,0,4,0,2,0,2,2,3,0,5
terminal,299,merged,0.13333333333333333,22.5,1,1,2,0,3,2,0,0,2,2,2,1,5
terminal,382,merged,0.0,11.5,0,1,8,0,9,0,1,0,1,0,0,0,0
terminal,431,rejected,0.0,26.5,0,0,2,0,2,0,0,0,0,0,8,0,8
terminal,699,merged,0.12121212121212122,16.5,1,1,3,2,6,0,2,0,2,0,2,0,2
terminal,638,merged,0.06451612903225806,15.5,1,0,5,1,6,0,0,0,0,0,3,0,3
terminal,119,merged,0.0,16.5,0,3,2,0,5,1,0,0,1,0,3,0,3
terminal,196,merged,0.0,23.5,0,0,1,0,1,0,2,0,2,0,6,0,6
terminal,423,merged,0.0,10.5,0,0,8,0,8,1,0,0,1,0,0,0,0
terminal,477,rejected,0.14634146341463414,20.5,1,0,3,0,3,1,0,0,1,1,3,1,5
terminal,578,rejected,0.0,9.5,0,0,9,0,9,0,0,0,0,0,0,0,0
terminal,633,rejected,0.0,16.5,0,1,4,0,5,0,1,0,1,0,3,0,3
terminal,658,merged,0.08,12.5,1,1,3,1,5,0,2,0,2,1,0,0,1
terminal,702,merged,0.0,9.5,0,1,8,0,9,0,0,0,0,0,0,0,0
terminal,836,merged,0.1276595744680851,23.5,1,1,0,0,1,1,1,0,2,0,5,1,6
terminal,185,merged,0.0,23.5,0,0,0,0,0,0,1,0,1,0,7,0,7
terminal,263,rejected,0.11764705882352941,8.5,1,1,6,1,8,0,0,0,0,0,0,0,0
terminal,262,merged,0.0,14.5,0,1,1,0,2,2,1,0,3,0,2,0,2
terminal,375,merged,0.0,18.5,0,1,1,0,2,0,2,0,2,0,4,0,4
terminal,461,rejected,0.11764705882352941,8.5,1,4,3,1,8,0,0,0,0,0,0,0,0
terminal,749,merged,0.09302325581395349,21.5,1,0,0,0,0,0,2,1,3,0,5,0,5
terminal,710,merged,0.09523809523809523,10.5,1,0,5,1,6,0,2,0,2,0,0,0,0
terminal,730,merged,0.0,8.5,0,1,7,0,8,0,0,0,0,0,0,0,0
terminal,769,merged,0.0,22.5,0,0,1,0,1,0,0,0,0,0,7,0,7
terminal,786,rejected,0.10526315789473684,9.5,1,1,5,1,7,0,1,0,1,0,0,0,0
terminal,813,merged,0.1935483870967742,15.5,1,0,4,0,4,0,1,0,1,0,2,1,3
terminal,190,merged,0.0,12.5,0,1,3,0,4,0,1,0,1,0,2,0,2
terminal,180,rejected,0.0,10.5,0,1,4,0,5,0,1,0,1,0,1,0,1
terminal,165,merged,0.0,19.5,0,0,0,0,0,0,2,0,2,0,5,0,5
terminal,253,merged,0.1935483870967742,15.5,1,1,1,0,2,2,0,0,2,0,2,1,3
terminal,533,merged,0.0,16.5,0,0,2,0,2,1,0,0,1,1,3,0,4
terminal,527,merged,0.3448275862068966,14.5,1,0,1,2,3,0,1,0,1,1,1,1,3
terminal,557,rejected,0.11764705882352941,8.5,1,1,4,1,6,0,1,0,1,0,0,0,0
terminal,701,merged,0.15384615384615385,19.5,1,0,0,0,0,1,1,0,2,0,4,1,5
terminal,264,merged,0.13333333333333333,7.5,1,1,5,1,7,0,0,0,0,0,0,0,0
terminal,772,merged,0.23529411764705882,8.5,1,2,2,2,6,0,1,0,1,0,0,0,0
terminal,788,rejected,0.05714285714285714,17.5,1,0,1,1,2,0,0,0,0,0,5,0,5
terminal,777,merged,0.0,15.5,0,2,1,0,3,0,0,0,0,0,4,0,4
terminal,95,rejected,0.0,11.5,0,0,3,0,3,0,1,0,1,0,2,0,2
terminal,234,rejected,0.15384615384615385,6.5,1,1,4,1,6,0,0,0,0,0,0,0,0
terminal,333,rejected,0.15384615384615385,6.5,1,2,3,1,6,0,0,0,0,0,0,0,0
terminal,391,rejected,0.15384615384615385,6.5,1,0,5,1,6,0,0,0,0,0,0,0,0
terminal,468,rejected,0.0,14.5,0,0,2,0,2,0,0,0,0,0,4,0,4
terminal,537,rejected,0.11764705882352941,8.5,1,0,3,1,4,0,2,0,2,0,0,0,0
terminal,571,rejected,0.0,6.5,0,2,4,0,6,0,0,0,0,0,0,0,0
terminal,680,rejected,0.26666666666666666,7.5,1,1,4,0,5,0,0,1,1,0,0,0,0
terminal,751,rejected,0.0,6.5,0,0,6,0,6,0,0,0,0,0,0,0,0
terminal,785,merged,0.0,16.5,0,1,0,0,1,0,0,0,0,1,4,0,5
terminal,105,rejected,0.0,5.5,0,0,5,0,5,0,0,0,0,0,0,0,0
terminal,189,merged,0.15384615384615385,6.5,1,0,3,1,4,0,1,0,1,0,0,0,0
terminal,129,merged,0.13333333333333333,7.5,1,0,2,1,3,2,0,0,2,0,0,0,0
terminal,157,merged,0.11764705882352941,8.5,1,0,1,1,2,1,2,0,3,0,0,0,0
terminal,275,merged,0.0,14.5,0,0,0,0,0,0,1,0,1,0,4,0,4
terminal,432,merged,0.0,11.5,0,0,2,0,2,0,0,0,0,0,3,0,3
terminal,447,merged,0.0,6.5,0,1,3,0,4,1,0,0,1,0,0,0,0
terminal,435,merged,0.0,10.5,0,2,0,0,2,1,0,0,1,1,1,0,2
terminal,547,rejected,0.15384615384615385,6.5,1,0,3,1,4,0,1,0,1,0,0,0,0
terminal,552,rejected,0.0,5.5,0,1,4,0,5,0,0,0,0,0,0,0,0
terminal,580,merged,0.15384615384615385,6.5,1,1,2,1,4,1,0,0,1,0,0,0,0
terminal,589,merged,0.15384615384615385,6.5,1,0,3,1,4,1,0,0,1,0,0,0,0
terminal,740,merged,0.0,11.5,0,1,0,0,1,2,0,0,2,0,2,0,2
terminal,193,rejected,0.0,5.5,0,0,3,0,3,0,1,0,1,0,0,0,0
terminal,200,merged,0.0,10.5,0,0,0,0,0,0,2,0,2,0,2,0,2
terminal,204,merged,0.0,6.5,0,0,2,0,2,1,1,0,2,0,0,0,0
terminal,136,merged,0.2608695652173913,11.5,1,0,0,0,0,0,1,0,1,0,2,1,3
terminal,146,rejected,0.0,11.5,0,0,0,0,0,1,0,0,1,0,3,0,3
terminal,417,rejected,0.0,4.5,0,1,3,0,4,0,0,0,0,0,0,0,0
terminal,404,merged,0.0,7.5,0,0,1,0,1,1,2,0,3,0,0,0,0
terminal,416,merged,0.2608695652173913,11.5,1,0,0,0,0,0,1,0,1,0,2,1,3
terminal,446,rejected,0.0,5.5,0,0,3,0,3,1,0,0,1,0,0,0,0
terminal,448,rejected,0.0,4.5,0,1,3,0,4,0,0,0,0,0,0,0,0
terminal,512,merged,0.0,9.5,0,0,0,0,0,0,0,0,0,1,2,0,3
terminal,546,rejected,0.2222222222222222,4.5,1,1,2,1,4,0,0,0,0,0,0,0,0
audacity,835,rejected,0.2936480388753905,1440.5,1,151,547,391,1089,1,1,1,3,5,100,10,115
audacity,1384,rejected,0.022193768672641914,1171.5,1,6,8,0,14,1,5,1,7,18,355,8,381
audacity,4414,merged,0.1249475890985325,1192.5,1,4,36,2,42,0,2,0,2,26,307,49,382
audacity,2295,merged,0.01794616151545364,501.5,1,3,18,1,22,0,0,1,1,10,147,2,159
audacity,5791,merged,0.07209062821833162,485.5,1,0,8,2,10,1,1,0,2,8,138,11,157
audacity,5043,merged,0.07169344870210136,404.5,1,5,30,2,37,0,2,0,2,5,107,9,121
audacity,4881,rejected,0.06799531066822978,426.5,1,0,11,2,13,0,1,0,1,17,111,9,137
audacity,3176,merged,0.04094488188976378,317.5,1,4,35,4,43,0,5,0,5,4,81,3,88
audacity,5041,merged,0.05067064083457526,335.5,1,4,22,1,27,0,2,2,4,12,84,4,100
audacity,1207,merged,0.024226110363391656,371.5,1,0,1,0,1,0,2,0,2,13,106,3,122
audacity,2121,merged,0.09155937052932761,349.5,1,3,6,2,11,1,3,0,4,13,87,10,110
audacity,836,merged,0.05598755832037325,321.5,1,4,11,9,24,0,3,0,3,7,87,3,97
audacity,4771,merged,0.07633587786259542,327.5,1,2,9,4,15,0,0,0,0,8,89,7,104
audacity,2668,merged,0.030456852791878174,295.5,1,2,8,0,10,0,0,0,0,5,87,3,95
audacity,4797,merged,0.07787610619469026,282.5,1,3,9,1,13,1,0,0,1,7,75,7,89
audacity,5138,merged,0.0425531914893617,211.5,1,1,43,3,47,0,1,0,1,4,48,2,54
audacity,3278,merged,0.045368620037807186,264.5,1,1,19,0,20,1,1,0,2,1,75,4,80
audacity,2867,merged,0.034904013961605584,286.5,1,0,6,1,7,0,3,0,3,4,84,3,91
audacity,759,rejected,0.0,258.5,0,3,3,0,6,0,0,0,0,0,84,0,84
audacity,3432,merged,0.10482180293501048,238.5,1,1,9,1,11,1,0,0,1,4,63,8,75
audacity,1193,rejected,0.017429193899782137,229.5,1,1,3,1,5,0,1,0,1,3,70,1,74
audacity,4853,rejected,0.16042780748663102,93.5,1,4,59,15,78,0,0,0,0,0,5,0,5
audacity,2224,merged,0.04081632653061224,220.5,1,2,5,3,10,3,3,0,6,2,62,2,66
audacity,4746,merged,0.13559322033898305,206.5,1,0,16,2,18,1,2,1,4,3,49,8,60
audacity,6068,merged,0.10401891252955082,211.5,1,3,6,1,10,0,3,0,3,4,54,7,65
audacity,4668,merged,0.09418282548476455,180.5,1,3,18,3,24,0,2,1,3,6,40,4,50
audacity,4701,merged,0.20048899755501223,204.5,1,0,8,2,10,0,1,0,1,8,43,13,64
audacity,5042,merged,0.04155844155844156,192.5,1,5,8,0,13,0,0,1,1,2,55,2,59
audacity,830,merged,0.05128205128205128,136.5,1,11,21,1,33,0,2,0,2,1,30,2,33
audacity,966,merged,0.04603580562659847,195.5,1,0,2,0,2,2,3,0,5,3,55,3,61
audacity,2941,merged,0.06808510638297872,117.5,1,6,32,5,43,0,1,0,1,0,23,1,24
audacity,4384,rejected,0.042440318302387266,188.5,1,3,3,2,8,0,0,0,0,3,55,2,60
audacity,3396,merged,0.027548209366391185,181.5,1,0,6,2,8,0,1,0,1,2,54,1,57
audacity,6359,merged,0.050156739811912224,159.5,1,3,11,2,16,1,3,0,4,1,42,2,45
audacity,1614,merged,0.047493403693931395,189.5,1,1,0,0,1,0,4,0,4,8,49,3,60
audacity,1679,merged,0.048,187.5,1,2,0,0,2,0,4,0,4,9,47,3,59
audacity,5818,merged,0.11221122112211221,151.5,1,0,15,5,20,1,0,0,1,2,37,4,43
audacity,1623,merged,0.13411078717201166,171.5,1,3,3,0,6,0,2,1,3,8,38,7,53
audacity,952,merged,0.0,176.5,0,0,2,0,2,0,0,0,0,6,52,0,58
audacity,3183,merged,0.02572347266881029,155.5,1,1,10,1,12,0,1,0,1,6,40,1,47
audacity,6395,merged,0.07881773399014778,101.5,1,5,25,5,35,0,0,0,0,1,20,1,22
audacity,3088,merged,0.06374501992031872,125.5,1,1,17,2,20,1,2,0,3,3,28,2,33
audacity,5874,merged,0.08524590163934426,152.5,1,0,7,1,8,0,0,0,0,1,43,4,48
audacity,2831,merged,0.1371841155234657,138.5,1,2,8,1,11,0,2,0,2,1,34,6,41
audacity,5139,merged,0.1078838174273859,120.5,1,0,15,4,19,0,1,0,1,2,28,3,33
audacity,5570,merged,0.13584905660377358,132.5,1,3,8,0,11,0,2,0,2,3,30,6,39
audacity,6094,merged,0.03162055335968379,126.5,1,0,13,2,15,1,1,1,3,1,34,0,35
audacity,3229,merged,0.04013377926421405,149.5,1,1,2,0,3,0,1,0,1,3,43,2,48
audacity,5980,merged,0.027906976744186046,107.5,1,7,13,0,20,2,1,0,3,3,23,1,27
audacity,4723,rejected,0.11483253588516747,104.5,1,1,19,3,23,0,0,0,0,2,22,3,27
audacity,5900,merged,0.0796812749003984,125.5,1,1,10,1,12,0,1,0,1,1,33,3,37
audacity,7590,merged,0.08480565371024736,141.5,1,0,0,0,0,0,0,0,0,3,40,4,47
audacity,1377,merged,0.199203187250996,125.5,1,0,6,0,6,1,4,2,7,2,26,7,35
audacity,5027,merged,0.024896265560165973,120.5,1,0,10,0,10,0,1,0,1,3,32,1,36
audacity,5965,merged,0.0,116.5,0,0,12,0,12,0,4,0,4,2,30,0,32
audacity,2801,merged,0.0106951871657754,93.5,1,2,19,1,22,0,1,0,1,0,23,0,23
audacity,5193,merged,0.0,116.5,0,0,9,0,9,0,1,0,1,5,30,0,35
audacity,3258,merged,0.059113300492610835,101.5,1,0,14,0,14,1,2,0,3,4,21,2,27
audacity,918,merged,0.06965174129353234,100.5,1,1,7,1,9,1,1,0,2,6,21,2,29
audacity,2565,merged,0.027149321266968326,110.5,1,0,6,0,6,0,1,0,1,4,29,1,34
audacity,5398,merged,0.06936416184971098,86.5,1,4,12,0,16,0,2,0,2,0,20,2,22
audacity,2536,merged,0.037267080745341616,80.5,1,4,12,3,19,0,2,0,2,0,19,0,19
audacity,5952,merged,0.11707317073170732,102.5,1,1,8,0,9,0,0,0,0,1,26,4,31
audacity,3030,rejected,0.02843601895734597,105.5,1,0,6,0,6,0,0,0,0,2,30,1,33
audacity,3696,merged,0.05673758865248227,70.5,1,0,22,1,23,1,0,0,1,2,12,1,15
audacity,4867,merged,0.06417112299465241,93.5,1,0,12,0,12,0,0,0,0,4,21,2,27
audacity,5685,merged,0.17886178861788618,61.5,1,2,17,8,27,0,2,0,2,0,9,1,10
audacity,3317,merged,0.04484304932735426,111.5,1,0,0,0,0,0,2,1,3,2,32,1,35
audacity,2957,rejected,0.05687203791469194,105.5,1,0,3,0,3,0,0,0,0,3,29,2,34
audacity,4739,merged,0.11494252873563218,43.5,1,11,17,5,33,1,1,0,2,0,2,0,2
audacity,2805,merged,0.049079754601226995,81.5,1,1,12,1,14,1,1,0,2,3,17,1,21
audacity,4795,merged,0.08530805687203792,105.5,1,0,1,0,1,1,0,0,1,5,26,3,34
audacity,5839,merged,0.032432432432432434,92.5,1,1,7,0,8,0,0,0,0,1,26,1,28
audacity,4033,merged,0.0,75.5,0,3,11,0,14,0,2,0,2,1,18,0,19
audacity,4171,merged,0.0,93.5,0,1,4,0,5,0,2,0,2,5,23,0,28
audacity,5653,merged,0.1773049645390071,70.5,1,0,16,0,16,0,0,3,3,0,14,2,16
audacity,8211,merged,0.05925925925925926,67.5,1,2,16,1,19,0,0,0,0,1,14,1,16
audacity,6472,merged,0.0,105.5,0,0,0,0,0,0,0,0,0,4,31,0,35
audacity,5899,rejected,0.15228426395939088,98.5,1,0,3,0,3,0,1,0,1,3,23,5,31
audacity,7561,merged,0.14218009478672985,105.5,1,0,0,0,0,0,0,0,0,4,26,5,35
audacity,1295,merged,0.07253886010362694,96.5,1,1,0,1,2,0,2,0,2,1,27,2,30
audacity,5789,rejected,0.11382113821138211,61.5,1,1,18,1,20,1,0,0,1,1,10,2,13
audacity,7515,merged,0.0,100.5,0,0,0,0,0,1,1,0,2,5,27,0,32
audacity,948,merged,0.0,97.5,0,1,0,0,1,0,0,0,0,3,29,0,32
audacity,1323,merged,0.06217616580310881,96.5,1,0,1,0,1,0,1,0,1,1,28,2,31
audacity,2261,merged,0.05847953216374269,85.5,1,0,4,2,6,1,1,0,2,2,22,1,25
audacity,3009,rejected,0.12834224598930483,93.5,1,0,3,0,3,0,0,0,0,2,24,4,30
audacity,7017,merged,0.032432432432432434,92.5,1,0,3,0,3,0,1,0,1,4,24,1,29
audacity,4053,rejected,0.13559322033898305,88.5,1,0,5,0,5,0,1,0,1,0,23,4,27
audacity,7785,merged,0.09045226130653267,99.5,1,0,0,0,0,0,0,0,0,4,26,3,33
audacity,2561,merged,0.0,79.5,0,2,6,0,8,0,1,0,1,4,19,0,23
audacity,3070,merged,0.03314917127071823,90.5,1,0,3,0,3,0,0,0,0,1,27,1,29
audacity,5675,rejected,0.05063291139240506,39.5,1,2,24,2,28,0,1,0,1,0,3,0,3
audacity,6306,rejected,0.10404624277456648,86.5,1,1,4,0,5,0,0,0,0,0,24,3,27
audacity,7978,merged,0.03428571428571429,87.5,1,1,3,0,4,0,1,0,1,6,20,1,27
audacity,1865,merged,0.16993464052287582,76.5,1,0,5,0,5,0,5,2,7,0,16,3,19
audacity,3996,merged,0.0,77.5,0,5,2,0,7,0,2,0,2,1,21,0,22
audacity,5239,merged,0.08247422680412371,48.5,1,7,14,1,22,0,1,0,1,4,3,1,8
audacity,3271,rejected,0.0,89.5,0,0,2,0,2,0,0,0,0,0,29,0,29
audacity,1482,merged,0.08,87.5,1,0,0,1,1,0,1,0,1,2,24,2,28
deluge,331,rejected,0.12134831460674157,222.5,1,37,70,24,131,2,0,0,2,0,28,1,29
deluge,338,rejected,0.06423982869379015,233.5,1,1,31,0,32,1,2,0,3,1,59,5,65
deluge,221,rejected,0.03404255319148936,117.5,1,3,9,1,13,0,1,0,1,5,28,1,34
deluge,57,merged,0.02390438247011952,125.5,1,0,5,0,5,0,0,0,0,2,37,1,40
deluge,181,rejected,0.0966183574879227,103.5,1,1,10,4,15,2,0,0,2,2,24,2,28
deluge,138,rejected,0.0,83.5,0,2,17,0,19,0,2,0,2,0,20,0,20
deluge,12,rejected,0.21761658031088082,96.5,1,1,11,0,12,0,0,0,0,2,19,7,28
deluge,180,merged,0.06289308176100629,79.5,1,2,10,2,14,0,1,0,1,1,19,1,21
deluge,359,rejected,0.15384615384615385,71.5,1,2,13,3,18,0,0,1,1,1,14,2,17
deluge,200,merged,0.2857142857142857,31.5,1,5,17,9,31,0,0,0,0,0,0,0,0
deluge,343,rejected,0.09836065573770492,30.5,1,7,17,3,27,0,0,0,0,0,1,0,1
deluge,14,rejected,0.08275862068965517,72.5,1,2,4,0,6,0,0,0,0,2,18,2,22
deluge,337,rejected,0.18487394957983194,59.5,1,2,5,2,9,0,1,0,1,2,11,3,16
deluge,369,rejected,0.08275862068965517,72.5,1,2,4,0,6,0,0,0,0,4,16,2,22
deluge,78,merged,0.0,57.5,0,0,9,0,9,0,0,0,0,0,16,0,16
deluge,454,rejected,0.037383177570093455,53.5,1,0,9,2,11,0,0,0,0,1,13,0,14
deluge,90,merged,0.0,64.5,0,0,4,0,4,0,0,0,0,2,18,0,20
deluge,196,rejected,0.0,50.5,0,2,8,0,10,0,2,0,2,1,11,0,12
deluge,67,rejected,0.04580152671755725,65.5,1,0,2,0,2,0,0,0,0,3,17,1,21
deluge,354,rejected,0.20952380952380953,52.5,1,3,2,3,8,0,0,1,1,1,11,2,14
deluge,376,rejected,0.12173913043478261,57.5,1,3,1,1,5,2,0,0,2,0,14,2,16
deluge,204,rejected,0.08163265306122448,24.5,1,4,15,2,21,0,0,0,0,0,1,0,1
deluge,352,rejected,0.1509433962264151,26.5,1,3,13,4,20,0,0,0,0,0,2,0,2
deluge,201,rejected,0.0,54.5,0,1,3,0,4,1,0,0,1,1,15,0,16
deluge,364,rejected,0.0,37.5,0,2,9,0,11,0,1,0,1,0,8,0,8
deluge,83,rejected,0.024096385542168676,41.5,1,0,7,1,8,0,0,0,0,2,9,0,11
deluge,50,merged,0.0,55.5,0,0,1,0,1,0,0,0,0,0,18,0,18
deluge,228,rejected,0.044444444444444446,22.5,1,6,9,1,16,0,0,0,0,0,2,0,2
deluge,93,merged,0.0,37.5,0,1,6,0,7,0,0,0,0,2,8,0,10
deluge,62,merged,0.0,31.5,0,2,8,0,10,0,0,0,0,1,6,0,7
deluge,224,rejected,0.0,30.5,0,0,10,0,10,1,0,0,1,0,6,0,6
deluge,353,rejected,0.1694915254237288,29.5,1,2,7,2,11,0,0,0,0,0,5,1,6
deluge,306,rejected,0.0,32.5,0,4,3,0,7,1,1,0,2,0,7,0,7
deluge,325,rejected,0.0759493670886076,39.5,1,1,3,0,4,0,1,0,1,0,10,1,11
deluge,5,rejected,0.0,15.5,0,2,13,0,15,0,0,0,0,0,0,0,0
deluge,19,rejected,0.17142857142857143,17.5,1,0,11,3,14,0,0,0,0,0,1,0,1
deluge,103,rejected,0.07228915662650602,41.5,1,0,2,0,2,0,0,0,0,1,11,1,13
deluge,296,rejected,0.1917808219178082,36.5,1,2,1,1,4,1,0,0,1,0,8,2,10
deluge,355,rejected,0.06060606060606061,16.5,1,1,12,1,14,0,1,0,1,0,0,0,0
deluge,462,rejected,0.031746031746031744,31.5,1,3,2,1,6,1,1,0,2,3,4,0,7
deluge,16,rejected,0.0,38.5,0,0,2,0,2,0,0,0,0,0,12,0,12
deluge,202,rejected,0.0,27.5,0,1,6,0,7,1,0,0,1,0,6,0,6
deluge,240,rejected,0.0,33.5,0,0,4,0,4,1,0,0,1,0,9,0,9
deluge,347,rejected,0.12903225806451613,15.5,1,1,10,2,13,1,0,0,1,0,0,0,0
deluge,377,rejected,0.028985507246376812,34.5,1,1,0,1,2,1,0,0,1,2,8,0,10
deluge,386,rejected,0.046511627906976744,21.5,1,6,3,1,10,0,1,0,1,1,2,0,3
deluge,99,merged,0.08450704225352113,35.5,1,0,2,0,2,0,0,0,0,1,9,1,11
deluge,115,rejected,0.0,13.5,0,0,13,0,13,0,0,0,0,0,0,0,0
deluge,175,rejected,0.09836065573770492,30.5,1,1,3,0,4,0,1,0,1,0,7,1,8
deluge,234,rejected,0.0,37.5,0,1,0,0,1,0,0,0,0,1,11,0,12
deluge,385,rejected,0.0,33.5,0,2,0,0,2,2,0,0,2,4,5,0,9
deluge,430,rejected,0.028169014084507043,35.5,1,0,1,1,2,0,0,0,0,0,11,0,11
deluge,10,rejected,0.0,34.5,0,0,1,0,1,0,0,0,0,0,11,0,11
deluge,34,rejected,0.32,12.5,1,2,6,4,12,0,0,0,0,0,0,0,0
deluge,65,rejected,0.0,20.5,0,0,8,0,8,0,0,0,0,0,4,0,4
deluge,79,merged,0.11764705882352941,25.5,1,0,4,0,4,0,0,0,0,1,5,1,7
deluge,105,rejected,0.0,21.5,0,0,6,0,6,0,0,0,0,0,5,0,5
deluge,133,merged,0.0,23.5,0,1,4,0,5,0,0,0,0,0,6,0,6
deluge,139,rejected,0.05405405405405406,18.5,1,0,6,1,7,0,1,0,1,0,3,0,3
deluge,342,rejected,0.22857142857142856,17.5,1,0,7,1,8,0,0,0,0,0,2,1,3
deluge,433,rejected,0.08695652173913043,11.5,1,3,7,1,11,0,0,0,0,0,0,0,0
deluge,427,rejected,0.0,27.5,0,1,2,0,3,0,0,0,0,0,8,0,8
deluge,109,rejected,0.0,18.5,0,1,5,0,6,0,0,0,0,0,4,0,4
deluge,158,merged,0.0,22.5,0,1,2,0,3,1,1,0,2,1,4,0,5
deluge,92,merged,0.11764705882352941,25.5,1,0,1,0,1,0,0,0,0,0,7,1,8
deluge,47,rejected,0.0,23.5,0,0,2,0,2,0,0,0,0,0,7,0,7
deluge,55,rejected,0.0,25.5,0,1,0,0,1,0,0,0,0,0,8,0,8
deluge,117,rejected,0.10526315789473684,9.5,1,3,5,1,9,0,0,0,0,0,0,0,0
deluge,334,rejected,0.14814814814814814,13.5,1,2,3,2,7,0,0,0,0,0,2,0,2
deluge,412,rejected,0.0,19.5,0,2,2,0,4,0,0,0,0,0,5,0,5
deluge,460,rejected,0.0,24.5,0,0,1,0,1,1,0,0,1,1,6,0,7
deluge,84,rejected,0.08,12.5,1,2,3,1,6,0,0,0,0,0,2,0,2
deluge,101,merged,0.14634146341463414,20.5,1,1,1,0,2,0,0,0,0,1,4,1,6
deluge,128,rejected,0.0,16.5,0,1,3,0,4,0,0,0,0,1,3,0,4
deluge,186,merged,0.0,17.5,0,0,2,0,2,0,0,0,0,0,5,0,5
deluge,189,rejected,0.0,12.5,0,2,4,0,6,0,0,0,0,0,2,0,2
deluge,226,rejected,0.0,13.5,0,2,3,0,5,0,1,0,1,0,2,0,2
deluge,215,rejected,0.35294117647058826,8.5,1,1,4,3,8,0,0,0,0,0,0,0,0
deluge,380,rejected,0.0,11.5,0,2,4,0,6,0,1,0,1,0,1,0,1
deluge,404,rejected,0.15384615384615385,19.5,1,0,2,0,2,1,0,0,1,0,4,1,5
deluge,372,rejected,0.0,20.5,0,2,0,0,2,0,0,0,0,0,6,0,6
deluge,68,rejected,0.08695652173913043,11.5,1,0,4,1,5,0,0,0,0,0,2,0,2
deluge,112,rejected,0.11764705882352941,8.5,1,2,3,1,6,0,1,0,1,0,0,0,0
deluge,124,merged,0.0,7.5,0,3,4,0,7,0,0,0,0,0,0,0,0
deluge,155,rejected,0.12903225806451613,15.5,1,0,1,2,3,0,0,0,0,0,4,0,4
deluge,170,rejected,0.4,7.5,1,2,2,3,7,0,0,0,0,0,0,0,0
deluge,244,rejected,0.0,7.5,0,3,4,0,7,0,0,0,0,0,0,0,0
deluge,256,rejected,0.17142857142857143,17.5,1,0,2,0,2,0,0,0,0,0,4,1,5
deluge,288,rejected,0.0,13.5,0,1,3,0,4,0,0,0,0,1,2,0,3
deluge,312,rejected,0.0,7.5,0,1,6,0,7,0,0,0,0,0,0,0,0
deluge,7,rejected,0.0,6.5,0,2,4,0,6,0,0,0,0,0,0,0,0
deluge,20,rejected,0.0,6.5,0,1,5,0,6,0,0,0,0,0,0,0,0
deluge,108,rejected,0.15384615384615385,6.5,1,1,4,1,6,0,0,0,0,0,0,0,0
deluge,122,rejected,0.0,12.5,0,1,2,0,3,0,0,0,0,0,3,0,3
deluge,157,rejected,0.0,6.5,0,2,4,0,6,0,0,0,0,0,0,0,0
deluge,187,rejected,0.0,11.5,0,1,2,0,3,0,1,0,1,0,2,0,2
deluge,203,rejected,0.0,15.5,0,1,0,0,1,1,0,0,1,0,4,0,4
deluge,289,rejected,0.09523809523809523,10.5,1,0,3,1,4,0,0,0,0,1,1,0,2
deluge,298,rejected,0.15384615384615385,6.5,1,2,3,1,6,0,0,0,0,0,0,0,0
deluge,332,rejected,0.0,7.5,0,3,2,0,5,0,1,0,1,0,0,0,0
IrrlichtBAW,358,merged,0.04837275475724702,2811.5,1,1,34,1,36,0,0,0,0,18,862,45,925
IrrlichtBAW,424,merged,0.061955861510427215,2469.5,1,0,7,1,8,0,1,1,2,21,748,50,819
IrrlichtBAW,410,merged,0.07701375245579568,1272.5,1,0,7,0,7,0,0,1,1,9,380,32,421
IrrlichtBAW,474,merged,0.06148282097649186,829.5,1,1,3,1,5,0,0,1,1,6,252,16,274
IrrlichtBAW,497,merged,0.03600900225056264,666.5,1,0,6,0,6,0,0,0,0,4,208,8,220
IrrlichtBAW,468,merged,0.04572396274343776,590.5,1,0,2,0,2,0,0,0,0,8,179,9,196
IrrlichtBAW,554,merged,0.058981233243967826,559.5,1,0,1,0,1,0,0,0,0,4,171,11,186
IrrlichtBAW,496,merged,0.0594059405940594,555.5,1,0,0,0,0,0,0,0,0,3,171,11,185
IrrlichtBAW,291,merged,0.06871609403254973,276.5,1,7,67,13,87,0,0,0,0,2,59,2,63
IrrlichtBAW,403,merged,0.05399325084364454,444.5,1,0,3,0,3,0,0,0,0,10,129,8,147
IrrlichtBAW,521,rejected,0.022857142857142857,437.5,1,1,6,1,8,0,0,0,0,4,136,3,143
IrrlichtBAW,411,merged,0.08298755186721991,361.5,1,0,1,0,1,0,0,0,0,1,109,10,120
IrrlichtBAW,307,merged,0.0559254327563249,375.5,1,2,4,0,6,0,0,0,0,3,113,7,123
IrrlichtBAW,21,rejected,0.14762741652021089,284.5,1,1,10,3,14,0,0,0,0,5,72,13,90
IrrlichtBAW,549,merged,0.07035175879396985,298.5,1,0,4,0,4,0,0,0,0,2,89,7,98
IrrlichtBAW,487,merged,0.05042016806722689,297.5,1,0,3,0,3,0,0,0,0,1,92,5,98
IrrlichtBAW,422,merged,0.0748663101604278,280.5,1,0,4,0,4,0,0,0,0,0,85,7,92
IrrlichtBAW,333,merged,0.02494802494802495,240.5,1,1,2,0,3,0,0,0,0,2,75,2,79
IrrlichtBAW,143,merged,0.07799442896935933,179.5,1,4,23,2,29,0,0,0,0,0,46,4,50
IrrlichtBAW,341,rejected,0.020050125313283207,199.5,1,1,8,1,10,0,0,0,0,5,57,1,63
IrrlichtBAW,373,rejected,0.013986013986013986,214.5,1,0,1,0,1,0,0,0,0,0,70,1,71
IrrlichtBAW,480,rejected,0.043583535108958835,206.5,1,0,2,0,2,0,0,0,0,1,64,3,68
IrrlichtBAW,402,rejected,0.045112781954887216,199.5,1,0,4,0,4,0,0,0,0,2,60,3,65
IrrlichtBAW,387,merged,0.08310249307479224,180.5,1,0,6,0,6,0,0,0,0,1,52,5,58
IrrlichtBAW,437,rejected,0.1391304347826087,172.5,1,0,7,0,7,0,0,0,0,2,45,8,55
IrrlichtBAW,301,merged,0.13058419243986255,145.5,1,1,8,1,10,0,0,0,0,5,34,6,45
IrrlichtBAW,483,merged,0.0,149.5,0,0,2,0,2,0,0,0,0,0,49,0,49
IrrlichtBAW,340,merged,0.02888086642599278,138.5,1,0,2,1,3,0,0,0,0,0,44,1,45
IrrlichtBAW,390,rejected,0.08695652173913043,80.5,1,2,20,1,23,0,0,0,0,0,17,2,19
IrrlichtBAW,172,merged,0.0,94.5,0,0,10,0,10,0,0,0,0,0,28,0,28
IrrlichtBAW,478,rejected,0.0,95.5,0,0,8,0,8,0,0,0,0,0,29,0,29
IrrlichtBAW,431,rejected,0.09944751381215469,90.5,1,2,4,0,6,0,0,0,0,0,25,3,28
IrrlichtBAW,455,merged,0.0,100.5,0,0,1,0,1,0,0,0,0,1,32,0,33
IrrlichtBAW,39,merged,0.024844720496894408,80.5,1,1,6,2,9,0,1,0,1,1,22,0,23
IrrlichtBAW,36,merged,0.014598540145985401,68.5,1,1,9,1,11,0,0,0,0,2,17,0,19
IrrlichtBAW,399,merged,0.12418300653594772,76.5,1,0,7,0,7,0,0,0,0,1,19,3,23
IrrlichtBAW,515,merged,0.03550295857988166,84.5,1,0,3,0,3,0,0,0,0,1,25,1,27
IrrlichtBAW,412,merged,0.11965811965811966,58.5,1,0,9,1,10,0,0,0,0,0,14,2,16
IrrlichtBAW,416,merged,0.10457516339869281,76.5,1,0,5,0,5,0,0,1,1,0,21,2,23
IrrlichtBAW,401,merged,0.0,72.5,0,0,6,0,6,0,0,0,0,5,17,0,22
IrrlichtBAW,244,merged,0.03076923076923077,32.5,1,5,20,1,26,0,0,0,0,1,1,0,2
IrrlichtBAW,553,merged,0.0,84.5,0,0,0,0,0,0,0,0,0,0,28,0,28
IrrlichtBAW,499,merged,0.0,72.5,0,0,3,0,3,0,0,0,0,0,23,0,23
IrrlichtBAW,524,merged,0.08163265306122448,73.5,1,0,1,0,1,0,0,0,0,1,21,2,24
IrrlichtBAW,552,rejected,0.08759124087591241,68.5,1,0,2,0,2,0,0,0,0,1,19,2,22
IrrlichtBAW,14,merged,0.0761904761904762,52.5,1,3,6,1,10,0,0,0,0,3,10,1,14
IrrlichtBAW,49,merged,0.0,63.5,0,0,3,0,3,0,0,0,0,0,20,0,20
IrrlichtBAW,265,merged,0.0,43.5,0,0,13,0,13,0,0,0,0,1,9,0,10
IrrlichtBAW,428,rejected,0.11764705882352941,42.5,1,2,5,5,12,0,0,0,0,0,10,0,10
IrrlichtBAW,540,rejected,0.0,62.5,0,0,2,0,2,0,0,0,0,0,20,0,20
IrrlichtBAW,425,merged,0.10084033613445378,59.5,1,0,2,0,2,0,0,0,0,1,16,2,19
IrrlichtBAW,81,merged,0.07017543859649122,28.5,1,3,11,2,16,0,0,0,0,0,4,0,4
IrrlichtBAW,389,merged,0.10256410256410256,58.5,1,0,1,0,1,0,0,0,0,1,16,2,19
IrrlichtBAW,63,merged,0.0,51.5,0,1,2,0,3,0,0,0,0,1,15,0,16
IrrlichtBAW,400,merged,0.061855670103092786,48.5,1,1,2,0,3,0,0,0,0,0,14,1,15
IrrlichtBAW,406,rejected,0.0,48.5,0,1,2,0,3,0,0,0,0,1,14,0,15
IrrlichtBAW,534,merged,0.11428571428571428,52.5,1,0,1,0,1,0,0,0,0,0,15,2,17
IrrlichtBAW,250,rejected,0.0,46.5,0,1,1,0,2,0,1,0,1,1,13,0,14
IrrlichtBAW,473,rejected,0.0,39.5,0,0,6,0,6,0,0,0,0,0,11,0,11
IrrlichtBAW,436,rejected,0.06741573033707865,44.5,1,0,2,0,2,0,0,0,0,0,13,1,14
IrrlichtBAW,271,merged,0.0,33.5,0,0,6,0,6,0,0,0,0,0,9,0,9
IrrlichtBAW,381,rejected,0.0,30.5,0,2,4,0,6,0,0,0,0,1,7,0,8
IrrlichtBAW,80,merged,0.0,32.5,0,2,3,0,5,0,0,0,0,1,8,0,9
IrrlichtBAW,297,merged,0.0,30.5,0,0,6,0,6,0,0,0,0,1,7,0,8
IrrlichtBAW,539,merged,0.0,18.5,0,0,12,0,12,0,0,0,0,0,2,0,2
IrrlichtBAW,386,rejected,0.17391304347826086,34.5,1,0,1,0,1,0,0,0,0,0,9,2,11
IrrlichtBAW,530,merged,0.09230769230769231,32.5,1,0,2,0,2,0,0,0,0,0,9,1,10
IrrlichtBAW,213,merged,0.1016949152542373,29.5,1,0,2,0,2,0,0,0,0,2,6,1,9
IrrlichtBAW,531,merged,0.09836065573770492,30.5,1,0,0,0,0,0,0,0,0,0,9,1,10
IrrlichtBAW,542,merged,0.5901639344262295,30.5,1,0,0,0,0,0,0,0,0,0,4,6,10
IrrlichtBAW,295,merged,0.0,11.5,0,1,7,0,8,0,0,0,0,0,1,0,1
IrrlichtBAW,398,merged,0.0,23.5,0,0,2,0,2,0,0,0,0,0,7,0,7
IrrlichtBAW,489,merged,0.0,14.5,0,0,5,0,5,0,0,0,0,1,2,0,3
IrrlichtBAW,48,merged,0.0,19.5,0,0,1,0,1,0,0,0,0,0,6,0,6
IrrlichtBAW,165,rejected,0.0,15.5,0,0,3,0,3,0,0,0,0,0,4,0,4
IrrlichtBAW,177,merged,0.15384615384615385,19.5,1,0,1,0,1,0,0,0,0,1,4,1,6
IrrlichtBAW,219,merged,0.0,13.5,0,1,3,0,4,0,0,0,0,0,3,0,3
IrrlichtBAW,378,merged,0.07407407407407407,13.5,1,2,1,1,4,0,0,0,0,0,3,0,3
IrrlichtBAW,443,rejected,0.05714285714285714,17.5,1,0,1,1,2,0,0,0,0,0,5,0,5
IrrlichtBAW,522,rejected,0.0,15.5,0,1,2,0,3,0,0,0,0,0,4,0,4
IrrlichtBAW,64,rejected,0.46153846153846156,6.5,1,1,2,3,6,0,0,0,0,0,0,0,0
IrrlichtBAW,164,merged,0.0,6.5,0,1,5,0,6,0,0,0,0,0,0,0,0
IrrlichtBAW,249,rejected,0.0,14.5,0,0,2,0,2,0,0,0,0,0,4,0,4
IrrlichtBAW,529,merged,0.16216216216216217,18.5,1,0,0,0,0,0,0,0,0,0,5,1,6
IrrlichtBAW,181,rejected,0.0,11.5,0,0,2,0,2,0,0,0,0,0,3,0,3
IrrlichtBAW,328,rejected,0.0,11.5,0,0,2,0,2,0,0,0,0,0,3,0,3
IrrlichtBAW,415,merged,0.0,13.5,0,1,0,0,1,0,0,0,0,0,4,0,4
IrrlichtBAW,475,rejected,0.0,9.5,0,0,3,0,3,0,0,0,0,0,2,0,2
IrrlichtBAW,490,merged,0.0,5.5,0,1,4,0,5,0,0,0,0,0,0,0,0
IrrlichtBAW,186,merged,0.0,4.5,0,1,3,0,4,0,0,0,0,0,0,0,0
IrrlichtBAW,187,merged,0.0,4.5,0,0,4,0,4,0,0,0,0,0,0,0,0
IrrlichtBAW,488,merged,0.0,12.5,0,0,0,0,0,0,0,0,0,0,4,0,4
IrrlichtBAW,462,rejected,0.0,10.5,0,0,1,0,1,0,0,0,0,0,3,0,3
IrrlichtBAW,514,merged,0.0,4.5,0,0,4,0,4,0,0,0,0,0,0,0,0
IrrlichtBAW,520,merged,0.0,12.5,0,0,0,0,0,0,0,0,0,0,4,0,4
IrrlichtBAW,138,merged,0.0,3.5,0,0,3,0,3,0,0,0,0,0,0,0,0
IrrlichtBAW,222,merged,0.0,7.5,0,0,1,0,1,0,0,0,0,0,2,0,2
IrrlichtBAW,284,merged,0.2857142857142857,3.5,1,0,2,1,3,0,0,0,0,0,0,0,0
IrrlichtBAW,275,merged,0.0,3.5,0,0,3,0,3,0,0,0,0,0,0,0,0
IrrlichtBAW,375,merged,0.0,3.5,0,2,1,0,3,0,0,0,0,0,0,0,0
cinnamon-desktop,98,merged,0.0,28.5,0,4,7,0,11,0,1,0,1,0,5,0,5
cinnamon-desktop,248,merged,0.0,10.5,0,1,9,0,10,0,0,0,0,0,0,0,0
cinnamon-desktop,250,rejected,0.15384615384615385,6.5,1,2,3,1,6,0,0,0,0,0,0,0,0
cinnamon-desktop,96,rejected,0.0,6.5,0,1,5,0,6,0,0,0,0,0,0,0,0
cinnamon-desktop,43,merged,0.0,5.5,0,0,5,0,5,0,0,0,0,0,0,0,0
cinnamon-desktop,49,rejected,0.2727272727272727,5.5,1,1,3,1,5,0,0,0,0,0,0,0,0
cinnamon-desktop,237,merged,0.0,5.5,0,1,4,0,5,0,0,0,0,0,0,0,0
cinnamon-desktop,193,rejected,0.11764705882352941,8.5,1,0,1,1,2,0,0,0,0,0,2,0,2
cinnamon-desktop,3,merged,0.4,2.5,1,0,1,1,2,0,0,0,0,0,0,0,0
cinnamon-desktop,70,rejected,0.0,3.5,0,0,3,0,3,0,0,0,0,0,0,0,0
cinnamon-desktop,80,merged,0.0,3.5,0,1,2,0,3,0,0,0,0,0,0,0,0
cinnamon-desktop,204,merged,0.2857142857142857,3.5,1,0,2,1,3,0,0,0,0,0,0,0,0
cinnamon-desktop,13,merged,0.0,2.5,0,1,1,0,2,0,0,0,0,0,0,0,0
cinnamon-desktop,82,merged,0.0,2.5,0,2,0,0,2,0,0,0,0,0,0,0,0
cinnamon-desktop,105,rejected,0.0,2.5,0,0,2,0,2,0,0,0,0,0,0,0,0
cinnamon-desktop,111,rejected,0.0,2.5,0,0,2,0,2,0,0,0,0,0,0,0,0
cinnamon-desktop,185,merged,0.0,2.5,0,0,2,0,2,0,0,0,0,0,0,0,0
cinnamon-desktop,236,rejected,0.6666666666666666,4.5,1,0,1,0,1,0,0,0,0,0,0,1,1
cinnamon-desktop,245,rejected,0.0,4.5,0,0,1,0,1,0,0,0,0,0,1,0,1
cinnamon-desktop,11,rejected,0.0,1.5,0,0,1,0,1,0,0,0,0,0,0,0,0
cinnamon-desktop,7,merged,0.0,1.5,0,0,1,0,1,0,0,0,0,0,0,0,0
cinnamon-desktop,53,merged,0.0,1.5,0,0,1,0,1,0,0,0,0,0,0,0,0
cinnamon-desktop,23,merged,0.0,1.5,0,0,1,0,1,0,0,0,0,0,0,0,0
cinnamon-desktop,51,merged,0.0,1.5,0,0,1,0,1,0,0,0,0,0,0,0,0
cinnamon-desktop,67,merged,0.0,1.5,0,0,1,0,1,0,0,0,0,0,0,0,0
cinnamon-desktop,79,merged,0.0,1.5,0,0,1,0,1,0,0,0,0,0,0,0,0
cinnamon-desktop,83,merged,0.0,1.5,0,0,1,0,1,0,0,0,0,0,0,0,0
cinnamon-desktop,112,rejected,0.0,1.5,0,0,1,0,1,0,0,0,0,0,0,0,0
cinnamon-desktop,119,rejected,0.0,1.5,0,0,1,0,1,0,0,0,0,0,0,0,0
cinnamon-desktop,130,merged,0.0,1.5,0,0,1,0,1,0,0,0,0,0,0,0,0
cinnamon-desktop,133,rejected,0.0,1.5,0,0,1,0,1,0,0,0,0,0,0,0,0
cinnamon-desktop,134,merged,0.0,1.5,0,0,1,0,1,0,0,0,0,0,0,0,0
cinnamon-desktop,141,rejected,0.0,1.5,0,0,1,0,1,0,0,0,0,0,0,0,0
cinnamon-desktop,174,rejected,0.0,1.5,0,0,1,0,1,0,0,0,0,0,0,0,0
cinnamon-desktop,178,rejected,0.0,1.5,0,0,1,0,1,0,0,0,0,0,0,0,0
cinnamon-desktop,196,rejected,0.0,1.5,0,0,1,0,1,0,0,0,0,0,0,0,0
cinnamon-desktop,207,merged,0.0,1.5,0,1,0,0,1,0,0,0,0,0,0,0,0
cinnamon-desktop,213,rejected,0.0,3.5,0,0,0,0,0,0,0,0,0,0,1,0,1
cinnamon-desktop,10,merged,0.0,0.5,0,0,0,0,0,0,0,0,0,0,0,0,0
cinnamon-desktop,9,rejected,0.0,0.5,0,0,0,0,0,0,0,0,0,0,0,0,0
cinnamon-desktop,56,merged,0.0,0.5,0,0,0,0,0,0,0,0,0,0,0,0,0
cinnamon-desktop,4,merged,0.0,0.5,0,0,0,0,0,0,0,0,0,0,0,0,0
cinnamon-desktop,1,merged,0.0,0.5,0,0,0,0,0,0,0,0,0,0,0,0,0
cinnamon-desktop,2,merged,0.0,0.5,0,0,0,0,0,0,0,0,0,0,0,0,0
cinnamon-desktop,6,merged,0.0,0.5,0,0,0,0,0,0,0,0,0,0,0,0,0
cinnamon-desktop,58,merged,0.0,0.5,0,0,0,0,0,0,0,0,0,0,0,0,0
cinnamon-desktop,59,rejected,0.0,0.5,0,0,0,0,0,0,0,0,0,0,0,0,0
cinnamon-desktop,20,merged,0.0,0.5,0,0,0,0,0,0,0,0,0,0,0,0,0
cinnamon-desktop,25,merged,0.0,0.5,0,0,0,0,0,0,0,0,0,0,0,0,0
cinnamon-desktop,26,merged,0.0,0.5,0,0,0,0,0,0,0,0,0,0,0,0,0
cinnamon-desktop,24,merged,0.0,0.5,0,0,0,0,0,0,0,0,0,0,0,0,0
cinnamon-desktop,27,merged,0.0,0.5,0,0,0,0,0,0,0,0,0,0,0,0,0
cinnamon-desktop,22,merged,0.0,0.5,0,0,0,0,0,0,0,0,0,0,0,0,0
cinnamon-desktop,21,merged,0.0,0.5,0,0,0,0,0,0,0,0,0,0,0,0,0
cinnamon-desktop,28,merged,0.0,0.5,0,0,0,0,0,0,0,0,0,0,0,0,0
cinnamon-desktop,29,merged,0.0,0.5,0,0,0,0,0,0,0,0,0,0,0,0,0
cinnamon-desktop,37,merged,0.0,0.5,0,0,0,0,0,0,0,0,0,0,0,0,0
cinnamon-desktop,41,merged,0.0,0.5,0,0,0,0,0,0,0,0,0,0,0,0,0
cinnamon-desktop,42,merged,0.0,0.5,0,0,0,0,0,0,0,0,0,0,0,0,0
cinnamon-desktop,36,merged,0.0,0.5,0,0,0,0,0,0,0,0,0,0,0,0,0
cinnamon-desktop,45,rejected,0.0,0.5,0,0,0,0,0,0,0,0,0,0,0,0,0
cinnamon-desktop,44,merged,0.0,0.5,0,0,0,0,0,0,0,0,0,0,0,0,0
cinnamon-desktop,47,rejected,0.0,0.5,0,0,0,0,0,0,0,0,0,0,0,0,0
cinnamon-desktop,52,merged,0.0,0.5,0,0,0,0,0,0,0,0,0,0,0,0,0
cinnamon-desktop,62,merged,0.0,0.5,0,0,0,0,0,0,0,0,0,0,0,0,0
cinnamon-desktop,63,merged,0.0,0.5,0,0,0,0,0,0,0,0,0,0,0,0,0
cinnamon-desktop,66,merged,0.0,0.5,0,0,0,0,0,0,0,0,0,0,0,0,0
cinnamon-desktop,65,merged,0.0,0.5,0,0,0,0,0,0,0,0,0,0,0,0,0
cinnamon-desktop,32,merged,0.0,0.5,0,0,0,0,0,0,0,0,0,0,0,0,0
cinnamon-desktop,31,merged,0.0,0.5,0,0,0,0,0,0,0,0,0,0,0,0,0
cinnamon-desktop,33,rejected,0.0,0.5,0,0,0,0,0,0,0,0,0,0,0,0,0
cinnamon-desktop,16,merged,0.0,0.5,0,0,0,0,0,0,0,0,0,0,0,0,0
cinnamon-desktop,17,rejected,0.0,0.5,0,0,0,0,0,0,0,0,0,0,0,0,0
cinnamon-desktop,19,merged,0.0,0.5,0,0,0,0,0,0,0,0,0,0,0,0,0
cinnamon-desktop,35,merged,0.0,0.5,0,0,0,0,0,0,0,0,0,0,0,0,0
cinnamon-desktop,77,merged,0.0,0.5,0,0,0,0,0,0,0,0,0,0,0,0,0
cinnamon-desktop,74,merged,0.0,0.5,0,0,0,0,0,0,0,0,0,0,0,0,0
cinnamon-desktop,73,merged,0.0,0.5,0,0,0,0,0,0,0,0,0,0,0,0,0
cinnamon-desktop,72,merged,0.0,0.5,0,0,0,0,0,0,0,0,0,0,0,0,0
cinnamon-desktop,71,merged,0.0,0.5,0,0,0,0,0,0,0,0,0,0,0,0,0
cinnamon-desktop,89,rejected,0.0,0.5,0,0,0,0,0,0,0,0,0,0,0,0,0
cinnamon-desktop,90,merged,0.0,0.5,0,0,0,0,0,0,0,0,0,0,0,0,0
cinnamon-desktop,88,merged,0.0,0.5,0,0,0,0,0,0,0,0,0,0,0,0,0
cinnamon-desktop,85,merged,0.0,0.5,0,0,0,0,0,0,0,0,0,0,0,0,0
cinnamon-desktop,86,merged,0.0,0.5,0,0,0,0,0,0,0,0,0,0,0,0,0
cinnamon-desktop,87,merged,0.0,0.5,0,0,0,0,0,0,0,0,0,0,0,0,0
cinnamon-desktop,92,merged,0.0,0.5,0,0,0,0,0,0,0,0,0,0,0,0,0
cinnamon-desktop,84,merged,0.0,0.5,0,0,0,0,0,0,0,0,0,0,0,0,0
cinnamon-desktop,78,merged,0.0,0.5,0,0,0,0,0,0,0,0,0,0,0,0,0
cinnamon-desktop,97,merged,0.0,0.5,0,0,0,0,0,0,0,0,0,0,0,0,0
cinnamon-desktop,100,merged,0.0,0.5,0,0,0,0,0,0,0,0,0,0,0,0,0
cinnamon-desktop,115,merged,0.0,0.5,0,0,0,0,0,0,0,0,0,0,0,0,0
cinnamon-desktop,113,merged,0.0,0.5,0,0,0,0,0,0,0,0,0,0,0,0,0
cinnamon-desktop,116,merged,0.0,0.5,0,0,0,0,0,0,0,0,0,0,0,0,0
cinnamon-desktop,109,merged,0.0,0.5,0,0,0,0,0,0,0,0,0,0,0,0,0
cinnamon-desktop,106,merged,0.0,0.5,0,0,0,0,0,0,0,0,0,0,0,0,0
cinnamon-desktop,123,merged,0.0,0.5,0,0,0,0,0,0,0,0,0,0,0,0,0
cinnamon-desktop,126,merged,0.0,0.5,0,0,0,0,0,0,0,0,0,0,0,0,0
cinnamon-desktop,127,merged,0.0,0.5,0,0,0,0,0,0,0,0,0,0,0,0,0
cinnamon-desktop,128,merged,0.0,0.5,0,0,0,0,0,0,0,0,0,0,0,0,0
cinnamon,4996,merged,0.10884353741496598,73.5,1,19,31,5,55,0,0,0,0,1,4,1,6
cinnamon,7944,merged,0.12121212121212122,49.5,1,4,6,0,10,0,0,0,0,5,6,2,13
cinnamon,1737,rejected,0.24778761061946902,56.5,1,14,28,14,56,0,0,0,0,0,0,0,0
cinnamon,1636,merged,0.09900990099009901,50.5,1,15,30,5,50,0,0,0,0,0,0,0,0
cinnamon,1966,rejected,0.21052631578947367,47.5,1,2,29,10,41,0,0,0,0,0,2,0,2
cinnamon,6878,merged,0.2857142857142857,17.5,1,1,11,5,17,0,0,0,0,0,0,0,0
cinnamon,6993,rejected,0.07407407407407407,40.5,1,11,24,3,38,0,1,0,1,0,0,0,0
cinnamon,8428,rejected,0.10650887573964497,84.5,1,3,9,4,16,0,0,1,1,0,21,1,22
cinnamon,8150,merged,0.0,5.5,0,0,5,0,5,0,0,0,0,0,0,0,0
cinnamon,5798,merged,0.057971014492753624,34.5,1,11,21,2,34,0,0,0,0,0,0,0,0
cinnamon,1717,rejected,0.09836065573770492,30.5,1,7,20,3,30,0,0,0,0,0,0,0,0
cinnamon,1888,rejected,0.06779661016949153,29.5,1,5,22,2,29,0,0,0,0,0,0,0,0
cinnamon,5324,merged,0.3389830508474576,29.5,1,5,14,10,29,0,0,0,0,0,0,0,0
cinnamon,7149,merged,0.09032258064516129,77.5,1,1,3,1,5,0,0,0,0,4,18,2,24
cinnamon,8617,merged,0.22535211267605634,35.5,1,6,15,5,26,0,0,0,0,0,2,1,3
cinnamon,7255,rejected,0.1791044776119403,33.5,1,3,15,6,24,0,0,0,0,0,3,0,3
cinnamon,8884,rejected,0.2028985507246377,34.5,1,6,12,7,25,0,0,0,0,0,3,0,3
cinnamon,847,merged,0.10909090909090909,27.5,1,10,14,3,27,0,0,0,0,0,0,0,0
cinnamon,5780,merged,0.14545454545454545,27.5,1,4,19,4,27,0,0,0,0,0,0,0,0
cinnamon,6872,rejected,0.0,1.5,0,0,1,0,1,0,0,0,0,0,0,0,0
cinnamon,7943,rejected,0.0,1.5,0,0,1,0,1,0,0,0,0,0,0,0,0
cinnamon,9771,rejected,0.2909090909090909,27.5,1,3,16,8,27,0,0,0,0,0,0,0,0
cinnamon,3553,rejected,0.18666666666666668,37.5,1,4,8,7,19,0,0,0,0,0,6,0,6
cinnamon,1679,merged,0.0392156862745098,25.5,1,3,21,1,25,0,0,0,0,0,0,0,0
cinnamon,1814,merged,0.20408163265306123,24.5,1,5,14,5,24,0,0,0,0,0,0,0,0
cinnamon,877,rejected,0.32653061224489793,24.5,1,3,13,8,24,0,0,0,0,0,0,0,0
cinnamon,1598,rejected,0.16326530612244897,24.5,1,3,17,4,24,0,0,0,0,0,0,0,0
cinnamon,11770,rejected,0.12244897959183673,24.5,1,1,20,3,24,0,0,0,0,0,0,0,0
cinnamon,2662,merged,0.0,27.5,0,4,17,0,21,0,0,0,0,0,2,0,2
cinnamon,1803,merged,0.0,22.5,0,2,20,0,22,0,0,0,0,0,0,0,0
cinnamon,5974,rejected,0.4,22.5,1,5,8,9,22,0,0,0,0,0,0,0,0
cinnamon,7685,rejected,0.0,0.5,0,0,0,0,0,0,0,0,0,0,0,0,0
cinnamon,8251,rejected,0.10309278350515463,48.5,1,2,5,2,9,0,0,0,0,2,10,1,13
cinnamon,10372,merged,0.08888888888888889,22.5,1,13,7,2,22,0,0,0,0,0,0,0,0
cinnamon,1800,rejected,0.0975609756097561,20.5,1,8,10,2,20,0,0,0,0,0,0,0,0
cinnamon,6486,merged,0.08888888888888889,22.5,1,0,17,2,19,0,0,0,0,0,1,0,1
cinnamon,7376,merged,0.03278688524590164,30.5,1,2,10,1,13,1,0,0,1,2,3,0,5
cinnamon,7486,rejected,0.19047619047619047,10.5,1,0,8,2,10,0,0,0,0,0,0,0,0
cinnamon,7916,rejected,0.3076923076923077,19.5,1,2,11,6,19,0,0,0,0,0,0,0,0
cinnamon,8873,merged,0.0273972602739726,36.5,1,7,4,1,12,0,0,0,0,5,3,0,8
cinnamon,11228,rejected,0.13953488372093023,21.5,1,11,5,3,19,0,1,0,1,0,0,0,0
cinnamon,843,merged,0.09302325581395349,21.5,1,7,9,2,18,0,0,0,0,0,1,0,1
cinnamon,4338,rejected,0.05128205128205128,19.5,1,0,18,1,19,0,0,0,0,0,0,0,0
cinnamon,5859,merged,0.15384615384615385,19.5,1,2,14,3,19,0,0,0,0,0,0,0,0
cinnamon,1003,rejected,0.21621621621621623,18.5,1,1,13,4,18,0,0,0,0,0,0,0,0
cinnamon,1504,rejected,0.10810810810810811,18.5,1,4,12,2,18,0,0,0,0,0,0,0,0
cinnamon,7325,merged,0.21621621621621623,18.5,1,3,11,4,18,0,0,0,0,0,0,0,0
cinnamon,11665,rejected,0.10810810810810811,18.5,1,3,13,2,18,0,0,0,0,0,0,0,0
cinnamon,1086,merged,0.05714285714285714,17.5,1,3,13,1,17,0,0,0,0,0,0,0,0
cinnamon,892,merged,0.05714285714285714,17.5,1,10,6,1,17,0,0,0,0,0,0,0,0
cinnamon,8988,merged,0.11764705882352941,25.5,1,6,7,0,13,0,0,0,0,0,3,1,4
cinnamon,10377,rejected,0.05714285714285714,17.5,1,0,16,1,17,0,0,0,0,0,0,0,0
cinnamon,1293,rejected,0.06060606060606061,16.5,1,7,8,1,16,0,0,0,0,0,0,0,0
cinnamon,1701,rejected,0.48484848484848486,16.5,1,2,6,8,16,0,0,0,0,0,0,0,0
cinnamon,9957,rejected,0.36363636363636365,16.5,1,2,8,6,16,0,0,0,0,0,0,0,0
cinnamon,10499,rejected,0.06060606060606061,16.5,1,1,14,1,16,0,0,0,0,0,0,0,0
cinnamon,1719,rejected,0.06451612903225806,15.5,1,3,11,1,15,0,0,0,0,0,0,0,0
cinnamon,886,merged,0.1935483870967742,15.5,1,3,9,3,15,0,0,0,0,0,0,0,0
cinnamon,1232,rejected,0.10256410256410256,19.5,1,4,7,2,13,0,0,0,0,0,2,0,2
cinnamon,1620,rejected,0.12903225806451613,15.5,1,6,7,2,15,0,0,0,0,0,0,0,0
cinnamon,1655,rejected,0.1935483870967742,15.5,1,1,11,3,15,0,0,0,0,0,0,0,0
cinnamon,6708,rejected,0.1935483870967742,15.5,1,5,7,3,15,0,0,0,0,0,0,0,0
cinnamon,6226,rejected,0.3225806451612903,15.5,1,1,9,5,15,0,0,0,0,0,0,0,0
cinnamon,8008,rejected,0.3870967741935484,15.5,1,1,8,6,15,0,0,0,0,0,0,0,0
cinnamon,9133,merged,0.3870967741935484,15.5,1,2,7,6,15,0,0,0,0,0,0,0,0
cinnamon,9559,merged,0.11320754716981132,26.5,1,1,7,1,9,0,0,1,1,0,5,0,5
cinnamon,11548,merged,0.06451612903225806,15.5,1,2,12,1,15,0,0,0,0,0,0,0,0
cinnamon,11905,merged,0.12903225806451613,15.5,1,5,8,2,15,0,0,0,0,0,0,0,0
cinnamon,11664,merged,0.046511627906976744,21.5,1,1,10,1,12,0,0,0,0,1,2,0,3
cinnamon,3858,merged,0.20689655172413793,14.5,1,3,8,3,14,0,0,0,0,0,0,0,0
cinnamon,4229,rejected,0.20689655172413793,14.5,1,4,7,3,14,0,0,0,0,0,0,0,0
cinnamon,6992,merged,0.0,7.5,0,1,6,0,7,0,0,0,0,0,0,0,0
cinnamon,8314,merged,0.0,22.5,0,3,4,0,7,2,1,0,3,0,3,0,3
cinnamon,11530,rejected,0.0,14.5,0,2,12,0,14,0,0,0,0,0,0,0,0
cinnamon,1831,merged,0.07407407407407407,13.5,1,2,10,1,13,0,0,0,0,0,0,0,0
cinnamon,1273,rejected,0.2222222222222222,13.5,1,1,9,3,13,0,0,0,0,0,0,0,0
cinnamon,3877,rejected,0.07407407407407407,13.5,1,5,7,1,13,0,0,0,0,0,0,0,0
cinnamon,5829,merged,0.14814814814814814,13.5,1,5,6,2,13,0,0,0,0,0,0,0,0
cinnamon,6821,rejected,0.2222222222222222,13.5,1,1,9,3,13,0,0,0,0,0,0,0,0
cinnamon,6694,merged,0.07407407407407407,13.5,1,3,9,1,13,0,0,0,0,0,0,0,0
cinnamon,7187,rejected,0.16,12.5,1,2,8,2,12,0,0,0,0,0,0,0,0
cinnamon,7252,merged,0.0,13.5,0,3,10,0,13,0,0,0,0,0,0,0,0
cinnamon,7395,merged,0.046511627906976744,21.5,1,1,4,1,6,0,0,0,0,1,4,0,5
cinnamon,8057,merged,0.0,12.5,0,6,6,0,12,0,0,0,0,0,0,0,0
cinnamon,8004,merged,0.08,12.5,1,1,10,1,12,0,0,0,0,0,0,0,0
cinnamon,8230,rejected,0.37037037037037035,13.5,1,0,8,5,13,0,0,0,0,0,0,0,0
cinnamon,8746,rejected,0.07407407407407407,13.5,1,2,10,1,13,0,0,0,0,0,0,0,0
cinnamon,9954,merged,0.0,13.5,0,8,5,0,13,0,0,0,0,0,0,0,0
cinnamon,10043,merged,0.18867924528301888,26.5,1,0,4,2,6,0,1,0,1,0,5,1,6
cinnamon,12100,rejected,0.07407407407407407,13.5,1,3,9,1,13,0,0,0,0,0,0,0,0
cinnamon,2006,rejected,0.08,12.5,1,2,9,1,12,0,0,0,0,0,0,0,0
cinnamon,2320,rejected,0.08,12.5,1,4,7,1,12,0,0,0,0,0,0,0,0
cinnamon,2779,merged,0.16,12.5,1,1,9,2,12,0,0,0,0,0,0,0,0
cinnamon,2765,rejected,0.24,12.5,1,2,7,3,12,0,0,0,0,0,0,0,0
cinnamon,673,rejected,0.16,12.5,1,3,7,2,12,0,0,0,0,0,0,0,0
cinnamon,1173,merged,0.0,12.5,0,1,11,0,12,0,0,0,0,0,0,0,0
cinnamon,1664,merged,0.08,12.5,1,5,6,1,12,0,0,0,0,0,0,0,0
cinnamon,1448,rejected,0.0,12.5,0,1,11,0,12,0,0,0,0,0,0,0,0
cinnamon,5556,merged,0.08,12.5,1,5,6,1,12,0,0,0,0,0,0,0,0
cinnamon,5942,merged,0.48,12.5,1,2,4,6,12,0,0,0,0,0,0,0,0
qBittorrent,15769,merged,0.11355034065102196,660.5,1,70,415,61,546,0,2,1,3,3,29,4,36
qBittorrent,7610,merged,0.1153649821337417,979.5,1,13,73,9,95,0,3,1,4,17,241,34,292
qBittorrent,12746,rejected,0.16222910216718267,807.5,1,11,94,30,135,1,1,1,3,6,183,33,222
qBittorrent,3989,merged,0.06291148500365765,683.5,1,19,84,13,116,0,0,0,0,11,168,10,189
qBittorrent,8584,merged,0.10770381451009724,668.5,1,9,70,13,92,0,5,1,6,4,165,19,188
qBittorrent,6911,merged,0.0357379219060225,755.5,1,5,16,7,28,0,1,1,2,7,228,6,241
qBittorrent,6779,merged,0.07878369039391846,723.5,1,6,32,3,41,1,1,0,2,10,198,18,226
qBittorrent,6698,rejected,0.08021877848678213,548.5,1,20,61,12,93,0,3,1,4,4,135,10,149
qBittorrent,12144,rejected,0.05455962587685113,641.5,1,2,31,8,41,0,0,0,0,2,189,9,200
qBittorrent,10702,merged,0.10738255033557047,521.5,1,7,82,9,98,1,4,1,6,3,119,15,137
qBittorrent,4936,merged,0.08029878618113913,535.5,1,13,68,10,91,0,0,0,0,4,133,11,148
qBittorrent,15915,merged,0.057097541633624106,630.5,1,4,25,3,32,0,2,0,2,0,187,11,198
qBittorrent,5877,merged,0.06498781478472786,615.5,1,4,28,2,34,1,2,1,4,7,172,12,191
qBittorrent,5214,merged,0.09881847475832438,465.5,1,10,85,13,108,1,2,0,3,8,98,11,117
qBittorrent,5532,merged,0.07685589519650655,572.5,1,11,35,3,49,1,6,1,8,10,146,13,169
qBittorrent,6627,merged,0.10754553339115351,576.5,1,5,35,3,43,0,6,1,7,6,148,19,173
qBittorrent,5196,merged,0.12181616832779624,451.5,1,9,60,10,79,0,0,0,0,9,100,15,124
qBittorrent,5287,merged,0.09137055837563451,492.5,1,11,39,6,56,0,5,0,5,1,128,13,142
qBittorrent,13885,merged,0.09929078014184398,493.5,1,8,40,7,55,0,3,0,3,7,123,14,144
qBittorrent,16840,merged,0.1088,312.5,1,7,111,10,128,0,2,0,2,1,51,8,60
qBittorrent,4681,rejected,0.10577864838393732,510.5,1,2,28,3,33,0,0,0,0,10,132,17,159
qBittorrent,5310,rejected,0.0888208269525268,326.5,1,12,92,11,115,1,1,0,2,0,63,6,69
qBittorrent,11833,rejected,0.13201970443349753,507.5,1,0,21,2,23,0,1,1,2,2,137,21,160
qBittorrent,10527,merged,0.10176531671858775,481.5,1,4,26,4,34,2,4,0,6,3,127,15,145
qBittorrent,3810,rejected,0.18124341412012646,474.5,1,6,16,8,30,0,0,0,0,5,117,26,148
qBittorrent,12458,merged,0.09989594172736732,480.5,1,1,19,3,23,0,2,0,2,3,133,15,151
qBittorrent,4994,merged,0.0781758957654723,460.5,1,6,17,6,29,0,1,0,1,3,130,10,143
qBittorrent,15453,rejected,0.13711583924349882,211.5,1,33,95,23,151,0,0,0,0,2,16,2,20
qBittorrent,6156,merged,0.06033182503770739,331.5,1,16,52,11,79,2,1,0,3,4,75,3,82
qBittorrent,9704,rejected,0.06390532544378698,422.5,1,1,23,1,25,0,1,1,2,4,119,8,131
qBittorrent,4266,merged,0.1269296740994854,291.5,1,22,42,22,86,0,2,0,2,5,57,5,67
qBittorrent,13348,rejected,0.10810810810810811,166.5,1,13,123,12,148,0,0,0,0,0,4,2,6
qBittorrent,9072,rejected,0.12314709236031927,438.5,1,0,9,3,12,0,0,0,0,5,120,17,142
qBittorrent,9375,merged,0.1363040629095675,381.5,1,2,30,2,34,0,0,1,1,5,94,16,115
qBittorrent,10948,rejected,0.09762202753441802,399.5,1,1,18,3,22,1,3,0,4,0,111,12,123
qBittorrent,9562,merged,0.10262828535669587,399.5,1,3,6,2,11,1,4,0,5,5,108,13,126
qBittorrent,11433,merged,0.11856474258970359,320.5,1,6,34,6,46,0,4,1,5,1,77,10,88
qBittorrent,20951,merged,0.07956600361663653,276.5,1,12,32,4,48,0,0,0,0,6,64,6,76
qBittorrent,5264,merged,0.0963855421686747,373.5,1,5,12,3,20,0,1,0,1,5,101,11,117
qBittorrent,12480,merged,0.11958762886597939,242.5,1,2,62,11,75,0,1,0,1,3,46,6,55
qBittorrent,12205,rejected,0.14947683109118087,334.5,1,2,21,2,25,0,0,0,0,5,82,16,103
qBittorrent,16485,merged,0.10526315789473684,237.5,1,5,43,7,55,0,1,0,1,0,54,6,60
qBittorrent,10099,rejected,0.1306715063520871,275.5,1,4,37,6,47,0,0,0,0,1,65,10,76
qBittorrent,12169,rejected,0.141643059490085,176.5,1,20,56,19,95,0,0,0,0,5,20,2,27
qBittorrent,15330,merged,0.0757825370675453,303.5,1,6,21,2,29,0,2,0,2,5,78,7,90
qBittorrent,6186,rejected,0.10062893081761007,238.5,1,8,44,6,58,0,0,0,0,4,50,6,60
qBittorrent,8347,merged,0.09819967266775777,305.5,1,2,21,3,26,0,0,0,0,5,79,9,93
qBittorrent,11241,merged,0.09880749574105621,293.5,1,6,17,5,28,0,2,0,2,3,76,8,87
qBittorrent,11708,merged,0.1378026070763501,268.5,1,2,32,5,39,2,2,1,5,4,59,10,73
qBittorrent,14054,merged,0.07603305785123966,302.5,1,1,13,3,17,0,2,1,3,1,86,6,93
qBittorrent,4253,merged,0.1459227467811159,116.5,1,29,68,17,114,1,0,0,1,0,0,0,0
qBittorrent,2550,merged,0.14349775784753363,111.5,1,19,76,16,111,0,0,0,0,0,0,0,0
qBittorrent,5090,merged,0.11764705882352941,263.5,1,10,21,7,38,0,0,0,0,4,63,8,75
qBittorrent,6952,merged,0.04056795131845842,246.5,1,13,23,2,38,0,1,1,2,8,58,2,68
qBittorrent,4984,rejected,0.0838095238095238,262.5,1,2,25,4,31,0,0,0,0,5,66,6,77
qBittorrent,13327,merged,0.0840630472854641,285.5,1,1,16,0,17,0,2,0,2,0,80,8,88
qBittorrent,14959,rejected,0.11830985915492957,177.5,1,8,44,15,67,0,1,0,1,3,31,2,36
qBittorrent,9007,rejected,0.09034907597535935,243.5,1,3,33,1,37,0,1,0,1,2,59,7,68
qBittorrent,13288,merged,0.26719056974459726,254.5,1,2,20,5,27,0,1,0,1,2,52,21,75
qBittorrent,19542,rejected,0.09703504043126684,185.5,1,0,7,0,7,0,2,0,2,3,49,6,58
qBittorrent,9824,merged,0.09504950495049505,252.5,1,4,18,6,28,1,0,0,1,2,66,6,74
qBittorrent,15888,merged,0.05649717514124294,265.5,1,2,6,0,8,0,1,0,1,2,78,5,85
qBittorrent,2892,merged,0.08866995073891626,101.5,1,6,86,9,101,0,0,0,0,0,0,0,0
qBittorrent,9600,merged,0.09262435677530018,291.5,1,1,3,0,4,0,4,0,4,4,80,9,93
qBittorrent,3235,merged,0.09416195856873823,265.5,1,1,13,2,16,0,2,1,3,4,70,7,81
qBittorrent,9349,rejected,0.1575178997613365,209.5,1,2,36,4,42,0,0,1,1,0,46,9,55
qBittorrent,11592,merged,0.0872865275142315,263.5,1,2,13,2,17,1,2,0,3,0,73,7,80
qBittorrent,15793,merged,0.030226700251889168,198.5,1,4,40,4,48,0,2,1,3,0,48,0,48
qBittorrent,9541,merged,0.09694793536804308,278.5,1,2,2,0,4,0,2,0,2,3,78,9,90
qBittorrent,18645,rejected,0.0757238307349666,224.5,1,1,5,2,8,0,3,0,3,2,63,5,70
qBittorrent,12574,merged,0.08849557522123894,169.5,1,11,39,6,56,0,1,0,1,7,27,3,37
qBittorrent,20118,rejected,0.1892744479495268,158.5,1,4,40,9,53,0,0,0,0,0,28,7,35
qBittorrent,7522,merged,0.049079754601226995,244.5,1,2,13,0,15,4,1,0,5,4,65,4,73
qBittorrent,1984,rejected,0.13100436681222707,114.5,1,10,56,15,81,0,0,0,0,0,11,0,11
qBittorrent,13498,rejected,0.13756613756613756,94.5,1,9,63,13,85,0,0,0,0,0,3,0,3
qBittorrent,5195,rejected,0.08086253369272237,185.5,1,3,20,6,29,0,0,0,0,4,45,3,52
qBittorrent,11354,merged,0.09411764705882353,127.5,1,5,56,12,73,0,0,0,0,1,17,0,18
qBittorrent,13266,rejected,0.133630289532294,224.5,1,2,10,0,12,0,1,0,1,2,58,10,70
qBittorrent,8427,merged,0.11042944785276074,244.5,1,1,5,1,7,1,1,1,3,4,65,8,77
qBittorrent,10175,merged,0.14382022471910114,222.5,1,2,16,2,20,0,2,0,2,0,56,10,66
qBittorrent,10384,rejected,0.09937888198757763,241.5,1,0,11,1,12,0,1,1,2,0,68,7,75
qBittorrent,18735,rejected,0.06965174129353234,100.5,1,4,63,7,74,0,1,0,1,0,8,0,8
qBittorrent,2757,merged,0.04040404040404041,148.5,1,12,43,3,58,0,0,0,0,0,29,1,30
qBittorrent,3150,merged,0.14634146341463414,184.5,1,5,26,6,37,0,0,0,0,0,42,7,49
qBittorrent,12434,rejected,0.2327790973871734,210.5,1,0,16,1,17,0,2,0,2,1,46,16,63
qBittorrent,20833,merged,0.10138248847926268,108.5,1,11,14,5,30,0,0,0,0,0,24,2,26
qBittorrent,2389,merged,0.021352313167259787,140.5,1,4,49,3,56,0,0,0,0,0,28,0,28
qBittorrent,9026,merged,0.13975903614457832,207.5,1,1,16,2,19,0,4,0,4,1,50,9,60
qBittorrent,21300,merged,0.12285012285012285,203.5,1,4,21,1,26,0,0,0,0,3,48,8,59
qBittorrent,11614,merged,0.08306709265175719,156.5,1,2,39,5,46,0,0,1,1,1,33,2,36
qBittorrent,12557,merged,0.06042296072507553,165.5,1,8,31,2,41,1,0,1,2,1,37,2,40
qBittorrent,15452,merged,0.09577464788732394,177.5,1,4,19,8,31,0,4,0,4,1,42,3,46
qBittorrent,17389,merged,0.08856088560885608,135.5,1,5,40,6,51,0,0,0,0,0,26,2,28
qBittorrent,20314,merged,0.11634349030470914,180.5,1,1,15,3,19,0,1,0,1,1,46,6,53
qBittorrent,14465,merged,0.09302325581395349,107.5,1,6,55,7,68,0,0,0,0,1,11,1,13
qBittorrent,19777,merged,0.07038123167155426,170.5,1,1,19,3,23,0,6,0,6,0,42,3,45
qBittorrent,19801,merged,0.06956521739130435,172.5,1,4,10,1,15,0,1,1,2,6,42,3,51
qBittorrent,2332,merged,0.12738853503184713,78.5,1,3,65,10,78,0,0,0,0,0,0,0,0
qBittorrent,1703,merged,0.08917197452229299,78.5,1,7,64,7,78,0,0,0,0,0,0,0,0
qBittorrent,11637,merged,0.24186046511627907,107.5,1,3,48,12,63,0,0,1,1,2,8,4,14
Civ,634,merged,0.11267605633802817,106.5,1,0,1,0,1,0,0,0,0,2,29,4,35
Civ,550,merged,0.11382113821138211,61.5,1,1,6,1,8,1,0,0,1,1,14,2,17
Civ,606,merged,0.17054263565891473,64.5,1,1,2,0,3,1,0,1,2,0,16,3,19
Civ,383,merged,0.03278688524590164,30.5,1,0,11,1,12,0,0,0,0,0,6,0,6
Civ,319,merged,0.0,34.5,0,0,4,0,4,0,0,0,0,1,9,0,10
Civ,564,rejected,0.05405405405405406,18.5,1,0,8,1,9,0,0,0,0,0,3,0,3
Civ,397,rejected,0.07407407407407407,13.5,1,0,10,1,11,0,1,0,1,0,0,0,0
Civ,631,rejected,0.09836065573770492,30.5,1,0,1,0,1,0,1,0,1,0,8,1,9
Civ,750,rejected,0.0,15.5,0,0,9,0,9,0,0,0,0,0,2,0,2
Civ,746,rejected,0.36363636363636365,16.5,1,0,4,3,7,0,0,0,0,0,2,1,3
Civ,552,rejected,0.11764705882352941,8.5,1,0,7,1,8,0,0,0,0,0,0,0,0
Civ,334,merged,0.0,13.5,0,1,4,0,5,0,1,0,1,0,2,0,2
Civ,353,merged,0.41379310344827586,14.5,1,1,1,0,2,0,0,0,0,0,2,2,4
Civ,387,merged,0.0,18.5,0,0,0,0,0,0,0,0,0,0,6,0,6
Civ,398,rejected,0.0,7.5,0,2,5,0,7,0,0,0,0,0,0,0,0
Civ,656,merged,0.15384615384615385,6.5,1,1,4,1,6,0,0,0,0,0,0,0,0
Civ,275,merged,0.2857142857142857,10.5,1,0,1,3,4,0,0,0,0,0,2,0,2
Civ,654,rejected,0.15384615384615385,6.5,1,1,4,1,6,0,0,0,0,0,0,0,0
Civ,2,merged,0.4,7.5,1,0,4,1,5,0,0,1,1,0,0,0,0
Civ,538,merged,0.0,5.5,0,1,4,0,5,0,0,0,0,0,0,0,0
Civ,745,rejected,0.15384615384615385,6.5,1,0,5,1,6,0,0,0,0,0,0,0,0
Civ,257,rejected,0.0,5.5,0,1,4,0,5,0,0,0,0,0,0,0,0
Civ,351,merged,0.08,12.5,1,0,0,1,1,1,0,0,1,0,3,0,3
Civ,729,merged,0.0,5.5,0,0,3,0,3,0,1,0,1,0,0,0,0
Civ,713,merged,0.0,8.5,0,0,2,0,2,0,0,0,0,1,1,0,2
Civ,676,rejected,0.09090909090909091,5.5,1,0,5,0,5,0,0,0,0,0,0,0,0
Civ,547,rejected,0.0,9.5,0,0,3,0,3,0,0,0,0,0,2,0,2
Civ,570,merged,0.0,11.5,0,0,2,0,2,0,0,0,0,0,3,0,3
Civ,568,merged,0.3157894736842105,9.5,1,0,3,0,3,0,0,0,0,0,1,1,2
Civ,262,merged,0.0,10.5,0,0,1,0,1,0,0,0,0,1,2,0,3
Civ,239,merged,0.0,12.5,0,0,0,0,0,0,0,0,0,1,3,0,4
Civ,321,merged,0.0,12.5,0,0,0,0,0,0,0,0,0,0,4,0,4
Civ,574,merged,0.0,3.5,0,0,3,0,3,0,0,0,0,0,0,0,0
Civ,740,merged,0.0,7.5,0,0,1,0,1,0,0,0,0,0,2,0,2
Civ,276,merged,0.0,3.5,0,1,2,0,3,0,0,0,0,0,0,0,0
Civ,273,merged,0.0,9.5,0,0,0,0,0,0,0,0,0,0,3,0,3
Civ,339,merged,0.0,9.5,0,0,0,0,0,0,0,0,0,0,3,0,3
Civ,639,merged,0.0,9.5,0,0,0,0,0,0,0,0,0,0,3,0,3
Civ,350,merged,0.0,9.5,0,0,0,0,0,0,0,0,0,0,3,0,3
Civ,386,merged,0.0,6.5,0,0,0,0,0,0,0,0,0,0,2,0,2
Civ,512,rejected,0.46153846153846156,6.5,1,0,0,0,0,0,0,0,0,0,1,1,2
Civ,602,rejected,0.0,3.5,0,0,3,0,3,0,0,0,0,0,0,0,0
Civ,675,rejected,0.0,3.5,0,1,2,0,3,0,0,0,0,0,0,0,0
Civ,356,merged,0.0,9.5,0,0,0,0,0,0,0,0,0,0,3,0,3
Civ,619,merged,0.058823529411764705,8.5,1,0,0,0,0,1,0,0,1,0,2,0,2
Civ,565,merged,0.0,9.5,0,0,0,0,0,0,0,0,0,0,3,0,3
Civ,585,merged,0.0,4.5,0,0,2,0,2,0,1,0,1,0,0,0,0
Civ,638,merged,0.0,6.5,0,0,0,0,0,0,0,0,0,0,2,0,2
Civ,630,merged,0.0,4.5,0,0,1,0,1,0,0,0,0,0,1,0,1
Civ,240,rejected,0.4,2.5,1,0,1,1,2,0,0,0,0,0,0,0,0
Civ,242,merged,0.4,2.5,1,0,1,1,2,0,0,0,0,0,0,0,0
Civ,329,merged,0.0,2.5,0,0,2,0,2,0,0,0,0,0,0,0,0
Civ,345,merged,0.0,3.5,0,0,1,0,1,0,1,0,1,0,0,0,0
Civ,375,rejected,0.4,2.5,1,0,1,1,2,0,0,0,0,0,0,0,0
Civ,385,merged,0.0,2.5,0,0,0,0,0,0,1,0,1,0,0,0,0
Civ,374,merged,0.0,3.5,0,0,1,0,1,0,1,0,1,0,0,0,0
Civ,580,merged,0.0,2.5,0,0,2,0,2,0,0,0,0,0,0,0,0
Civ,354,merged,0.0,3.5,0,1,0,0,1,0,1,0,1,0,0,0,0
Civ,481,merged,0.0,2.5,0,0,0,0,0,1,0,0,1,0,0,0,0
Civ,491,merged,0.0,2.5,0,0,0,0,0,1,0,0,1,0,0,0,0
Civ,393,rejected,0.0,2.5,0,0,2,0,2,0,0,0,0,0,0,0,0
Civ,604,merged,0.0,2.5,0,0,2,0,2,0,0,0,0,0,0,0,0
Civ,577,merged,0.0,2.5,0,0,2,0,2,0,0,0,0,0,0,0,0
Civ,615,rejected,0.8,2.5,1,0,0,2,2,0,0,0,0,0,0,0,0
Civ,671,rejected,0.4,2.5,1,0,1,1,2,0,0,0,0,0,0,0,0
Civ,392,rejected,0.0,2.5,0,0,2,0,2,0,0,0,0,0,0,0,0
Civ,497,merged,0.0,1.5,0,0,1,0,1,0,0,0,0,0,0,0,0
Civ,535,merged,0.0,1.5,0,0,1,0,1,0,0,0,0,0,0,0,0
Civ,645,merged,0.0,1.5,0,0,1,0,1,0,0,0,0,0,0,0,0
Civ,649,merged,0.0,1.5,0,0,1,0,1,0,0,0,0,0,0,0,0
Civ,635,merged,0.0,2.5,0,0,2,0,2,0,0,0,0,0,0,0,0
Civ,396,rejected,0.0,2.5,0,0,2,0,2,0,0,0,0,0,0,0,0
Civ,719,rejected,0.0,1.5,0,0,1,0,1,0,0,0,0,0,0,0,0
Civ,765,merged,0.0,6.5,0,0,0,0,0,0,0,0,0,0,2,0,2
Civ,752,merged,0.0,1.5,0,0,1,0,1,0,0,0,0,0,0,0,0
Civ,611,rejected,0.0,1.5,0,0,1,0,1,0,0,0,0,0,0,0,0
Civ,735,rejected,0.8,2.5,1,0,0,2,2,0,0,0,0,0,0,0,0
Civ,670,rejected,0.0,2.5,0,0,2,0,2,0,0,0,0,0,0,0,0
Civ,732,merged,0.0,0.5,0,0,0,0,0,0,0,0,0,0,0,0,0
Civ,272,merged,0.0,1.5,0,1,0,0,1,0,0,0,0,0,0,0,0
Civ,279,merged,0.0,1.5,0,1,0,0,1,0,0,0,0,0,0,0,0
Civ,311,merged,0.0,3.5,0,0,0,0,0,0,0,0,0,0,1,0,1
Civ,235,merged,0.0,1.5,0,1,0,0,1,0,0,0,0,0,0,0,0
Civ,237,merged,0.0,2.5,0,0,0,0,0,0,1,0,1,0,0,0,0
Civ,238,merged,0.0,2.5,0,0,0,0,0,0,1,0,1,0,0,0,0
Civ,338,merged,0.0,2.5,0,0,0,0,0,0,1,0,1,0,0,0,0
Civ,335,merged,0.0,3.5,0,0,0,0,0,0,0,0,0,0,1,0,1
Civ,371,merged,0.0,3.5,0,0,0,0,0,0,0,0,0,0,1,0,1
Civ,376,merged,0.0,2.5,0,0,0,0,0,0,1,0,1,0,0,0,0
Civ,389,merged,0.0,0.5,0,0,0,0,0,0,0,0,0,0,0,0,0
Civ,388,rejected,0.0,1.5,0,0,1,0,1,0,0,0,0,0,0,0,0
Civ,362,rejected,0.0,1.5,0,0,1,0,1,0,0,0,0,0,0,0,0
Civ,395,merged,0.0,2.5,0,0,0,0,0,1,0,0,1,0,0,0,0
Civ,406,merged,0.0,0.5,0,0,0,0,0,0,0,0,0,0,0,0,0
Civ,720,merged,0.0,0.5,0,0,0,0,0,0,0,0,0,0,0,0,0
Civ,726,merged,0.0,0.5,0,0,0,0,0,0,0,0,0,0,0,0,0
Civ,727,merged,0.0,0.5,0,0,0,0,0,0,0,0,0,0,0,0,0
Civ,394,merged,0.0,2.5,0,0,0,0,0,1,0,0,1,0,0,0,0
Civ,480,merged,0.0,0.5,0,0,0,0,0,0,0,0,0,0,0,0,0
Civ,487,merged,0.0,0.5,0,0,0,0,0,0,0,0,0,0,0,0,0
trivy,5439,merged,0.0392156862745098,382.5,1,7,11,1,19,2,3,1,6,8,105,4,117
trivy,7732,merged,0.04709576138147567,318.5,1,1,7,0,8,0,2,0,2,3,94,5,102
trivy,679,merged,0.05010438413361169,239.5,1,2,18,0,20,0,0,0,0,0,69,4,73
trivy,6781,merged,0.02962962962962963,202.5,1,2,9,0,11,1,3,0,4,5,54,2,61
trivy,5635,merged,0.0781758957654723,153.5,1,4,22,3,29,3,2,0,5,2,33,3,38
trivy,2333,rejected,0.015584415584415584,192.5,1,2,12,0,14,1,1,0,2,5,52,1,58
trivy,6234,merged,0.037383177570093455,160.5,1,0,1,0,1,0,0,0,0,2,49,2,53
trivy,8080,merged,0.057971014492753624,172.5,1,1,12,1,14,1,3,0,4,3,44,3,50
trivy,8177,merged,0.0380952380952381,157.5,1,6,8,0,14,0,1,0,1,5,40,2,47
trivy,99,rejected,0.15772870662460567,158.5,1,7,10,1,18,0,1,0,1,3,35,8,46
trivy,433,merged,0.050156739811912224,159.5,1,0,8,2,10,1,0,0,1,3,44,2,49
trivy,4058,merged,0.08530805687203792,105.5,1,7,21,6,34,1,0,0,1,1,21,1,23
trivy,542,rejected,0.03827751196172249,104.5,1,7,20,4,31,1,1,0,2,1,22,0,23
trivy,709,rejected,0.05245901639344262,152.5,1,2,7,0,9,0,0,1,1,0,45,2,47
trivy,6217,merged,0.06896551724137931,130.5,1,3,14,1,18,4,0,1,5,2,30,2,34
trivy,1437,merged,0.02247191011235955,133.5,1,0,5,0,5,0,1,0,1,0,41,1,42
trivy,4652,merged,0.0,139.5,0,1,2,0,3,1,4,0,5,6,36,0,42
trivy,6524,rejected,0.09049773755656108,110.5,1,5,9,7,21,1,0,0,1,2,26,1,29
trivy,8077,merged,0.019933554817275746,150.5,1,2,0,0,2,1,1,0,2,6,41,1,48
trivy,253,merged,0.02711864406779661,147.5,1,1,0,1,2,1,1,0,2,4,42,1,47
trivy,3015,merged,0.04938271604938271,121.5,1,4,6,0,10,3,0,0,3,7,26,2,35
trivy,751,merged,0.04938271604938271,121.5,1,2,2,0,4,3,0,0,3,1,34,2,37
trivy,1101,merged,0.0,126.5,0,0,0,0,0,0,0,0,0,0,42,0,42
trivy,2065,merged,0.07804878048780488,102.5,1,0,3,2,5,0,2,0,2,0,29,2,31
trivy,7131,merged,0.11857707509881422,126.5,1,1,1,0,2,2,0,3,5,2,33,3,38
trivy,2490,rejected,0.07751937984496124,64.5,1,12,20,2,34,0,0,0,0,1,8,1,10
trivy,7336,merged,0.012269938650306749,81.5,1,5,18,1,24,0,3,0,3,1,16,0,17
trivy,6993,merged,0.04145077720207254,96.5,1,1,9,1,11,1,1,0,2,4,22,1,27
trivy,7526,merged,0.0,106.5,0,4,5,0,9,0,2,0,2,3,28,0,31
trivy,5062,merged,0.02843601895734597,105.5,1,1,6,0,7,0,1,0,1,2,29,1,32
trivy,6176,merged,0.07407407407407407,121.5,1,0,0,0,0,1,1,0,2,3,33,3,39
trivy,50,merged,0.06857142857142857,87.5,1,6,4,3,13,0,1,0,1,0,23,1,24
trivy,5999,merged,0.07729468599033816,103.5,1,0,2,0,2,3,0,1,4,2,27,2,31
trivy,6476,merged,0.06857142857142857,87.5,1,0,4,0,4,0,4,0,4,3,20,2,25
trivy,6633,merged,0.0,40.5,0,1,1,0,2,0,1,0,1,1,11,0,12
trivy,7160,merged,0.05925925925925926,67.5,1,0,9,1,10,0,3,0,3,0,16,1,17
trivy,7605,merged,0.0,97.5,0,1,3,0,4,0,3,0,3,0,29,0,29
trivy,8294,merged,0.13953488372093023,107.5,1,0,0,0,0,0,1,0,1,2,28,5,35
trivy,935,merged,0.032432432432432434,92.5,1,1,2,0,3,1,0,0,1,3,25,1,29
trivy,1638,merged,0.029556650246305417,101.5,1,0,3,0,3,0,1,0,1,3,28,1,32
trivy,5285,merged,0.12716763005780346,86.5,1,1,3,3,7,1,0,1,2,6,17,2,25
trivy,8254,merged,0.05181347150259067,96.5,1,2,3,0,5,1,0,1,2,3,25,1,29
trivy,4047,merged,0.0,82.5,0,3,5,0,8,3,1,0,4,4,18,0,22
trivy,7340,merged,0.07272727272727272,82.5,1,2,8,0,10,0,3,0,3,0,20,2,22
trivy,6072,merged,0.044444444444444446,67.5,1,4,9,3,16,2,1,0,3,0,15,0,15
trivy,6275,merged,0.0,64.5,0,0,0,0,0,1,1,0,2,2,18,0,20
trivy,6674,merged,0.03821656050955414,78.5,1,2,3,0,5,0,2,0,2,2,20,1,23
trivy,8178,merged,0.0,68.5,0,0,15,0,15,0,1,0,1,0,17,0,17
trivy,2589,merged,0.0,48.5,0,5,17,0,22,0,1,0,1,0,8,0,8
trivy,2607,merged,0.014388489208633094,69.5,1,2,12,1,15,0,0,0,0,1,17,0,18
trivy,4557,merged,0.0,90.5,0,0,4,0,4,0,1,0,1,0,28,0,28
trivy,7261,merged,0.0784313725490196,76.5,1,2,2,0,4,1,2,0,3,1,19,2,22
trivy,7679,merged,0.04878048780487805,61.5,1,2,11,3,16,0,0,0,0,4,11,0,15
trivy,303,merged,0.031088082901554404,96.5,1,0,0,0,0,0,0,0,0,6,25,1,32
trivy,5154,merged,0.08053691275167785,74.5,1,3,5,0,8,3,0,0,3,8,10,2,20
trivy,3391,merged,0.0,54.5,0,1,6,0,7,1,0,0,1,0,15,0,15
trivy,7690,merged,0.0,72.5,0,5,4,0,9,0,3,0,3,3,16,0,19
trivy,1230,merged,0.2077922077922078,38.5,1,12,10,5,27,1,0,0,1,0,2,1,3
trivy,2951,merged,0.0,77.5,0,0,7,0,7,1,1,0,2,0,22,0,22
trivy,4210,merged,0.07100591715976332,84.5,1,2,1,0,3,0,0,0,0,1,24,2,27
trivy,7206,merged,0.07453416149068323,80.5,1,0,1,0,1,0,2,0,2,3,20,2,25
trivy,7163,merged,0.0,79.5,0,0,7,0,7,0,0,0,0,4,20,0,24
trivy,7444,merged,0.0,49.5,0,12,9,0,21,2,0,0,2,2,6,0,8
trivy,5059,merged,0.02247191011235955,44.5,1,10,11,1,22,2,0,0,2,0,6,0,6
trivy,6357,merged,0.016260162601626018,61.5,1,2,7,1,10,3,0,0,3,1,14,0,15
trivy,7339,rejected,0.035398230088495575,56.5,1,2,11,2,15,0,1,0,1,0,13,0,13
trivy,8244,merged,0.1317365269461078,83.5,1,0,1,2,3,1,0,0,1,8,15,3,26
trivy,1287,merged,0.015037593984962405,66.5,1,2,5,1,8,1,1,0,2,3,15,0,18
trivy,1756,merged,0.12307692307692308,32.5,1,13,9,4,26,2,1,0,3,0,0,0,0
trivy,7039,merged,0.0,66.5,0,2,8,0,10,0,1,0,1,4,14,0,18
trivy,435,merged,0.07453416149068323,80.5,1,0,0,0,0,1,0,0,1,1,23,2,26
trivy,1799,merged,0.04195804195804196,71.5,1,2,1,0,3,0,1,0,1,0,21,1,22
trivy,1832,merged,0.03592814371257485,83.5,1,0,0,0,0,1,0,0,1,7,19,1,27
trivy,2567,merged,0.03680981595092025,81.5,1,0,0,0,0,0,0,0,0,0,26,1,27
trivy,3599,merged,0.09195402298850575,43.5,1,3,14,1,18,0,2,0,2,0,6,1,7
trivy,7664,merged,0.0,56.5,0,2,8,0,10,0,2,0,2,4,10,0,14
trivy,1202,rejected,0.07272727272727272,27.5,1,7,16,2,25,0,1,0,1,0,0,0,0
trivy,3037,merged,0.07547169811320754,79.5,1,0,1,0,1,0,0,0,0,1,23,2,26
trivy,3215,merged,0.02247191011235955,44.5,1,11,6,1,18,1,0,0,1,1,7,0,8
trivy,6240,merged,0.0425531914893617,70.5,1,1,2,0,3,1,1,0,2,1,19,1,21
trivy,6329,merged,0.0,81.5,0,0,0,0,0,0,0,0,0,1,26,0,27
trivy,6882,merged,0.039735099337748346,75.5,1,0,1,0,1,2,2,0,4,1,20,1,22
trivy,6333,rejected,0.017699115044247787,56.5,1,1,8,1,10,2,0,0,2,1,13,0,14
trivy,8106,merged,0.0,72.5,0,0,2,0,2,0,2,0,2,0,22,0,22
trivy,376,merged,0.045112781954887216,66.5,1,3,3,0,6,0,0,0,0,3,16,1,20
trivy,4706,merged,0.017391304347826087,57.5,1,1,7,1,9,0,0,0,0,2,14,0,16
trivy,2186,merged,0.056338028169014086,35.5,1,1,8,2,11,0,0,0,0,1,7,0,8
trivy,2494,merged,0.10619469026548672,56.5,1,2,2,0,4,2,0,0,2,4,10,2,16
trivy,3130,merged,0.045112781954887216,66.5,1,1,5,0,6,0,0,0,0,4,15,1,20
trivy,5037,merged,0.0,66.5,0,0,0,0,0,0,0,0,0,2,20,0,22
trivy,1539,merged,0.0,75.5,0,0,0,0,0,0,0,0,0,1,24,0,25
trivy,2111,merged,0.0,56.5,0,1,8,0,9,0,1,0,1,0,15,0,15
trivy,2910,merged,0.056074766355140186,53.5,1,1,8,0,9,0,1,0,1,0,13,1,14
trivy,6861,merged,0.0,34.5,0,0,3,0,3,1,1,0,2,1,8,0,9
trivy,6965,merged,0.0,53.5,0,1,7,0,8,0,3,0,3,0,13,0,13
trivy,8134,merged,0.0,70.5,0,0,2,0,2,0,1,0,1,1,21,0,22
trivy,201,merged,0.0,66.5,0,0,1,0,1,1,0,0,1,1,20,0,21
trivy,552,merged,0.0,65.5,0,0,2,0,2,0,0,0,0,1,20,0,21
trivy,1081,merged,0.0,42.5,0,5,5,0,10,0,1,0,1,2,8,0,10
trivy,1668,merged,0.23622047244094488,63.5,1,2,1,1,4,0,0,1,1,4,11,4,19
